Date,Amount,Description,Balance,Subcategory,Category
2024-06-30,-3.4,Provender Australia SilverwateNSWAU,1987.25,Vending Machine,Food
2024-06-30,-3.4,Provender Australia SilverwateNSWAU,1990.65,Vending Machine,Food
2024-06-29,-43.33,Ho Jiak Haymarket Haymarket AU,1994.05,Restaurants,Food
2024-06-29,-3.4,PROVENDER HOLDINGS AUS Waterloo AU AUS Card xx1037 Value Date: 27/06/2024,2037.38,Vending Machine,Food
2024-06-28,-15.24,CHICKEN V SEOUL PTY WENTWORTH POINSWAU,2040.78,Restaurants,Food
2024-06-28,-0.53,International Transaction Fee Value Date: 26/06/2024,2056.02,Student Fees,Education
2024-06-28,-15.06,WWW.SYMBOLAB.COM REDWOOD CITY CA USA Card xx1037 USD 9.99 Value Date: 26/06/2024,2056.55,Online Subscriptions,Technology and Services
2024-06-28,-1.16,International Transaction Fee Value Date: 26/06/2024,2071.61,Student Fees,Education
2024-06-28,-33.17,OPENAI *CHATGPT SUBSCR SAN FRANCISCO CA USA Card xx1037 USD 22.00 Value Date: 26/06/2024,2072.77,Online Subscriptions,Technology and Services
2024-06-28,-23.34,PANCAKES ON THE ROCKS HAYMARKET NS AUS Card xx1037 Value Date: 26/06/2024,2105.94,Restaurants,Food
2024-06-27,-3.4,Provender Australia SilverwateNSWAU Value Date: 28/06/2024,2129.28,Vending Machine,Food
2024-06-27,-7.9,STARBUCKS COFFEE B00 SYDNEY AU,2132.68,Coffee,Food
2024-06-27,-35.0,TIMEZONE HAYMARKET AU Card xx1037,2140.58,Entertainment,Activities
2024-06-27,-5.08,Kensington Investment Chippendale AU,2175.58,Rent,Living Expenses
2024-06-27,-15.15,Kensington Investment Chippendale AU,2180.66,Rent,Living Expenses
2024-06-27,-31.8,NANDOS BROADWAY NSW Broadway AU AUS Card xx1037 Value Date: 25/06/2024,2195.81,Restaurants,Food
2024-06-27,-21.5,ICC Darling Harbour Sydney NS AUS Card xx1037 Value Date: 25/06/2024,2227.61,Entertainment,Activities
2024-06-27,-47.0,SCRIMBA OSLO DU NOR Card xx1037 AUD 47.00 Value Date: 26/06/2024,2249.11,Online Subscriptions,Technology and Services
2024-06-27,-10.0,TRANSPORTFORNSW OPAL CHIPPENDALE AUS Card xx1037 Value Date: 26/06/2024,2296.11,Transport,Living Expenses
2024-06-27,-4.2,Provender Australia SilverwateNSWAU,2306.11,Vending Machine,Food
2024-06-27,-3.2,Provender Australia SilverwateNSWAU,2310.31,Vending Machine,Food
2024-06-27,-3.4,Provender Australia SilverwateNSWAU,2313.51,Vending Machine,Food
2024-06-26,-20.28,FISH MARKET CAFE PYRMONT NS AUS Card xx1037 Value Date: 24/06/2024,2316.91,Restaurants,Food
2024-06-26,-0.26,International Transaction Fee Value Date: 24/06/2024,2337.19,Student Fees,Education
2024-06-26,-7.54,A MEDIUM CORPORATION 4155085008 CA USA Card xx1037 USD 5.00 Value Date: 24/06/2024,2337.45,Online Subscriptions,Technology and Services
2024-06-25,-7.1,STARBUCKS COFFEE B01 CHIPPENDALE AU,2344.99,Coffee,Food
2024-06-25,-23.34,PANCAKES ON THE ROCKS HAYMARKET NS AUS Card xx1037 Value Date: 22/06/2024,2352.09,Restaurants,Food
2024-06-25,-25.27,SWEET TOWN ON GEORGE S HAYMARKET 02 AUS Card xx1037 Value Date: 21/06/2024,2375.43,Restaurants,Food
2024-06-25,-4.62,ENJOY MIE SYDNEY 02 AUS Card xx1037 Value Date: 21/06/2024,2400.7,Restaurants,Food
2024-06-25,-21.98,ENJOY MIE SYDNEY 02 AUS Card xx1037 Value Date: 21/06/2024,2405.32,Restaurants,Food
2024-06-25,-25.37,PANCAKES ON THE ROCKS HAYMARKET NS AUS Card xx1037 Value Date: 23/06/2024,2427.3,Restaurants,Food
2024-06-25,-14.99,APPLE.COM/BILL SYDNEY NS AUS Card xx1037 Value Date: 22/06/2024,2452.67,Apple,Technology and Services
2024-06-25,-6.49,APPLE.COM/BILL SYDNEY AU AUS Card xx1037 Value Date: 22/06/2024,2467.66,Apple,Technology and Services
2024-06-25,-18.0,SMP*Hero Sushi George Sydney AU AUS Card xx1037 Value Date: 22/06/2024,2474.15,Restaurants,Food
2024-06-24,-15.23,Fruitezy Pyrmont AU,2492.15,Grocery,Food
2024-06-24,-4.2,Provender Australia SilverwateNSWAU,2507.38,Vending Machine,Food
2024-06-24,-3.4,Provender Australia SilverwateNSWAU,2511.58,Vending Machine,Food
2024-06-24,-3.4,Provender Australia SilverwateNSWAU,2514.98,Vending Machine,Food
2024-06-22,-49.99,BETWEEN THE FLAGS - CA BONDI BEACH AU AUS Card xx1037 Value Date: 20/06/2024,2518.38,Shopping,Financial Transactions
2024-06-22,-10.0,TRANSPORTFORNSW OPAL CHIPPENDALE AUS Card xx1037 Value Date: 20/06/2024,2568.37,Transport,Living Expenses
2024-06-20,-15.24,CHICKEN V SEOUL PTY WENTWORTH POINSWAU,2578.37,Restaurants,Food
2024-06-20,-1098.0,Direct Debit 505091 IGLU NO205 PTY 66935,2593.61,Rent,Living Expenses
2024-06-20,-24.29,SURFISH BONDI BEACH NSWAU,3691.61,Restaurants,Food
2024-06-20,3185.0,IZMIRTA RACHMAN REF 2024062000015270,3715.9,Credit,Financial Transactions
2024-06-20,-16.3,SUSHI HUB SKYVIEW PL SYDNEY NS AUS Card xx1037 Value Date: 17/06/2024,530.9,Restaurants,Food
2024-06-20,-4.2,Provender Australia SilverwateNSWAU,547.2,Vending Machine,Food
2024-06-19,-35.0,TIMEZONE HAYMARKET AU Card xx1037,551.4,Entertainment,Activities
2024-06-19,-29.0,LANGUAGE ACADEMY,586.4,Online Subscriptions,Technology and Services
2024-06-19,-21.74,FAT FISH Annandale AU,615.4,Restaurants,Food
2024-06-18,-15.24,CHICKEN V SEOUL PTY WENTWORTH POINSWAU,637.14,Restaurants,Food
2024-06-18,-54.99,LinkedIn Pre 965769569 lnkd.in/bill AU AUS Card xx1037 Value Date: 14/06/2024,652.38,Online Subscriptions,Technology and Services
2024-06-18,-4.49,APPLE.COM/BILL SYDNEY AU AUS Card xx1037 Value Date: 13/06/2024,707.37,Apple,Technology and Services
2024-06-18,-40.0,Carriageworks Eveleigh AU AUS Card xx1037 Value Date: 14/06/2024,711.86,Stationery,Education
2024-06-18,-9.74,DidiChuxing DIDI MOBIL Sydney AU AUS Card xx1037 Value Date: 14/06/2024,751.86,Transport,Living Expenses
2024-06-18,-15.29,Australian Collection Sydney NS AUS Card xx1037 Value Date: 15/06/2024,761.6,Shopping,Financial Transactions
2024-06-18,-21.98,ENJOY MIE SYDNEY 02 AUS Card xx1037 Value Date: 15/06/2024,776.89,Restaurants,Food
2024-06-18,-17.0,HAYMARKET SEAFOOD HAYMARKET AU AUS Card xx1037 Value Date: 16/06/2024,798.87,Restaurants,Food
2024-06-18,-25.27,SWEET TOWN ON GEORGE S HAYMARKET 02 AUS Card xx1037 Value Date: 16/06/2024,815.87,Restaurants,Food
2024-06-18,-10.0,TRANSPORTFORNSW OPAL CHIPPENDALE AUS Card xx1037 Value Date: 15/06/2024,841.14,Transport,Living Expenses
2024-06-17,-22.07,STARBUCKS COFFEE B00 SYDNEY AU,851.14,Coffee,Food
2024-06-17,-23.15,SQ *YUNNN PTY LTD Sydney AU,873.21,Restaurants,Food
2024-06-16,-7.6,STARBUCKS COFFEE B00 SYDNEY AU,896.36,Coffee,Food
2024-06-15,-26.52,SQ *EMMY'S GOURMET GOZ The Rocks AU,903.96,Restaurants,Food
2024-06-15,-35.0,TIMEZONE HAYMARKET AU Card xx1037,930.48,Entertainment,Activities
2024-06-15,-15.39,CHEMIST WAREHOUSE BONDI BEACH NS AUS Card xx1037 Value Date: 12/06/2024,965.48,Pharmacy,Personal Care
2024-06-14,-18.2,MCDONALDS BROADWAY SYDNEY NSWAU,980.87,Restaurants,Food
2024-06-14,-28.39,Roll'd Westfield Sydney AU,999.07,Restaurants,Food
2024-06-14,-4.0,LAT*IgluBroadway Chippindale AU AUS Card xx1037 Value Date: 11/06/2024,1027.46,Rent,Living Expenses
2024-06-14,-4.0,LAT*IgluBroadway Chippindale AU AUS Card xx1037 Value Date: 11/06/2024,1031.46,Rent,Living Expenses
2024-06-14,-4.0,LAT*IgluBroadway Chippindale AU AUS Card xx1037 Value Date: 11/06/2024,1035.46,Rent,Living Expenses
2024-06-14,-4.0,LAT*IgluBroadway Chippindale AU AUS Card xx1037 Value Date: 11/06/2024,1039.46,Rent,Living Expenses
2024-06-14,-4.0,LAT*IgluBroadway Chippindale AU AUS Card xx1037 Value Date: 11/06/2024,1043.46,Rent,Living Expenses
2024-06-14,-4.0,LAT*IgluBroadway Chippindale AU AUS Card xx1037 Value Date: 11/06/2024,1047.46,Rent,Living Expenses
2024-06-14,-1.59,International Transaction Fee Value Date: 12/06/2024,1051.46,Student Fees,Education
2024-06-14,-45.55,GRAMMARLY COXAXOD9Z 8883186146 CA USA Card xx1037 USD 30.00 Value Date: 12/06/2024,1053.05,Online Subscriptions,Technology and Services
2024-06-14,-60.0,Carriageworks Eveleigh AU AUS Card xx1037 Value Date: 12/06/2024,1098.6,Stationery,Education
2024-06-13,-8.4,STARBUCKS COFFEE B00 SYDNEY AU,1158.6,Coffee,Food
2024-06-13,-31.09,PEPPER LUNCH SYDNEY NSWAU,1167.0,Restaurants,Food
2024-06-13,-121.2,MEDIBANK PHI DEBIT MELBOURNE AUS Card xx1037 Value Date: 11/06/2024,1198.09,Student Fees,Education
2024-06-12,-15.24,CHICKEN V SEOUL PTY WENTWORTH POINSWAU,1319.29,Restaurants,Food
2024-06-12,-24.29,SURFISH BONDI BEACH NSWAU,1334.53,Restaurants,Food
2024-06-12,-33.0,SQ *PEKO PEKO ?????? Darlington NS AUS Card xx1037 Value Date: 10/06/2024,1358.82,Restaurants,Food
2024-06-12,-34.98,FISH MARKET CAFE PYRMONT NS AUS Card xx1037 Value Date: 08/06/2024,1391.82,Restaurants,Food
2024-06-12,-0.1,International Transaction Fee Value Date: 09/06/2024,1426.8,Student Fees,Education
2024-06-12,-2.8,Google Storage Mountain View CA USA Card xx1037 IDR 29859.00 Value Date: 09/06/2024,1426.9,Online Subscriptions,Technology and Services
2024-06-12,-3.4,Provender Australia SilverwateNSWAU,1429.7,Vending Machine,Food
2024-06-12,-3.4,Provender Australia SilverwateNSWAU,1433.1,Vending Machine,Food
2024-06-11,-35.0,TIMEZONE HAYMARKET AU Card xx1037,1436.5,Entertainment,Activities
2024-06-11,-18.55,SQ *ENJOY MIE Ultimo AU,1471.5,Restaurants,Food
2024-06-11,-13.99,Spotify P2CD17E320 Sydney AU AUS Card xx1037 Value Date: 08/06/2024,1490.05,Online Subscriptions,Technology and Services
2024-06-10,-26.35,SQ *DESSERT DEALER Pyrmont AU,1504.04,Food and Beverage,Food
2024-06-09,-21.83,SQ *ENJOY MIE Ultimo AU,1530.39,Restaurants,Food
2024-06-09,-17.99,Canva* 04177-13759430,1552.22,Online Subscriptions,Technology and Services
2024-06-08,-10.14,SQ *DESSERT DEALER Pyrmont AU,1570.21,Food and Beverage,Food
2024-06-08,-23.34,SQ *ANTICO WOODFIRED P Pyrmont AU,1580.35,Restaurants,Food
2024-06-08,-10.15,Fruitezy Pyrmont AU,1603.69,Grocery,Food
2024-06-08,-3.4,PROVENDER HOLDINGS AUS Waterloo AU AUS Card xx1037 Value Date: 06/06/2024,1613.84,Vending Machine,Food
2024-06-08,-4.2,PROVENDER HOLDINGS AUS Waterloo AU AUS Card xx1037 Value Date: 06/06/2024,1617.24,Vending Machine,Food
2024-06-08,-3.4,PROVENDER HOLDINGS AUS Waterloo AU AUS Card xx1037 Value Date: 06/06/2024,1621.44,Vending Machine,Food
2024-06-08,-23.34,PANCAKES ON THE ROCKS HAYMARKET NS AUS Card xx1037 Value Date: 06/06/2024,1624.84,Restaurants,Food
2024-06-07,-35.0,TIMEZONE HAYMARKET AU Card xx1037,1648.18,Entertainment,Activities
2024-06-07,-18.48,SQ *ENJOY MIE Ultimo AU,1683.18,Restaurants,Food
2024-06-06,-1098.0,Direct Debit 505091 IGLU NO205 PTY 66935,1701.66,Rent,Living Expenses
2024-06-06,-123.68,Direct Debit 119218 Vodafone Aus A3-2a910409,2799.66,Mobile Services,Technology and Services
2024-06-06,-3.2,Provender Australia SilverwateNSWAU,2923.34,Vending Machine,Food
2024-06-05,-18.48,SQ *ENJOY MIE Ultimo AU,2926.54,Restaurants,Food
2024-06-05,-20.8,PANCAKES ON THE ROCKS HAYMARKET NS AUS Card xx1037 Value Date: 03/06/2024,2945.02,Restaurants,Food
2024-06-05,-9.99,APPLE.COM/BILL SYDNEY NS AUS Card xx1037 Value Date: 03/06/2024,2965.82,Apple,Technology and Services
2024-06-05,-19.59,HUNGER KEBAB PTY LTD ULTIMO NS AUS Card xx1037 Value Date: 03/06/2024,2975.81,Restaurants,Food
2024-06-04,-11.5,TSG BROADWAY CHIPPENDALE NSW AU,2995.4,Food and Beverage,Food
2024-06-04,-22.84,Spago Darling Square Haymarket AU,3006.9,Restaurants,Food
2024-06-04,-20.49,APPLE.COM/BILL SYDNEY AU AUS Card xx1037 Value Date: 30/05/2024,3029.74,Apple,Technology and Services
2024-06-04,-13.99,CRUNCHYROLL *AUD 415-503-9235 CA USA Card xx1037 AUD 13.99 Value Date: 01/06/2024,3050.23,Online Subscriptions,Technology and Services
2024-06-04,-29.99,ADOBE ADOBE.LY/ENAU AU AUS Card xx1037 Value Date: 01/06/2024,3064.22,Online Subscriptions,Technology and Services
2024-06-04,-21.98,ENJOY MIE SYDNEY 02 AUS Card xx1037 Value Date: 02/06/2024,3094.21,Restaurants,Food
2024-06-03,-40.54,SQ *BRAZILIAN FLAME Ultimo AU,3116.19,Restaurants,Food
2024-06-03,-11.14,PANCAKES ON THE ROCKS,3156.73,Restaurants,Food
2024-06-02,-8.2,STARBUCKS COFFEE B01 CHIPPENDALE AU,3167.87,Coffee,Food
2024-06-01,-3.0,Provender Australia SilverwateNSWAU,3176.07,Vending Machine,Food
2024-06-01,-3.4,Provender Australia SilverwateNSWAU,3179.07,Vending Machine,Food
2024-06-01,-3.2,Provender Australia SilverwateNSWAU,3182.47,Vending Machine,Food
2024-06-01,-0.04,Debit Excess Interest,3185.67,Debit,Financial Transactions
2024-05-31,-23.34,SQ *ANTICO WOODFIRED P Pyrmont AU,3185.71,Restaurants,Food
2024-05-31,-7.5,ANDERSENS OF DENMARK ICE COOGEE NSW AU Card xx1037,3209.05,Food and Beverage,Food
2024-05-31,-18.14,SQ *ENJOY MIE Ultimo AU,3216.55,Restaurants,Food
2024-05-31,-32.48,Macchiato Sydney NS AUS Card xx1037 Value Date: 29/05/2024,3234.69,Food and Beverage,Food
2024-05-30,-19.4,PMC GOLDEN TOWER PTY L HAYMARKET AU,3267.17,Restaurants,Food
2024-05-29,-3.2,Provender Australia SilverwateNSWAU Value Date: 30/05/2024,3286.57,Vending Machine,Food
2024-05-29,-3.0,Provender Australia SilverwateNSWAU Value Date: 30/05/2024,3289.77,Vending Machine,Food
2024-05-29,-20.73,SQ *ENJOY MIE Ultimo AU,3292.77,Restaurants,Food
2024-05-29,-34.47,APPLE.COM/BILL SYDNEY AU AUS Card xx1037 Value Date: 25/05/2024,3313.5,Apple,Technology and Services
2024-05-28,-22.11,Goobne Chatime Sydney AU,3347.97,Food and Beverage,Food
2024-05-28,-22.76,SQ *ENJOY MIE Ultimo AU,3370.08,Restaurants,Food
2024-05-28,3185.0,IZMIRTA RACHMAN REF 2024052800013034,3392.84,Credit,Financial Transactions
2024-05-28,-0.26,International Transaction Fee Value Date: 24/05/2024,207.84,Student Fees,Education
2024-05-28,-7.57,A MEDIUM CORPORATION 4155085008 CA USA Card xx1037 USD 5.00 Value Date: 24/05/2024,208.1,Online Subscriptions,Technology and Services
2024-05-28,-47.0,SCRIMBA OSLO DU NOR Card xx1037 AUD 47.00 Value Date: 26/05/2024,215.67,Online Subscriptions,Technology and Services
2024-05-28,-0.53,International Transaction Fee Value Date: 26/05/2024,262.67,Student Fees,Education
2024-05-28,-15.16,WWW.SYMBOLAB.COM REDWOOD CITY CA USA Card xx1037 USD 9.99 Value Date: 26/05/2024,263.2,Online Subscriptions,Technology and Services
2024-05-28,-1.17,International Transaction Fee Value Date: 26/05/2024,278.36,Student Fees,Education
2024-05-28,-33.39,OPENAI *CHATGPT SUBSCR SAN FRANCISCO CA USA Card xx1037 USD 22.00 Value Date: 26/05/2024,279.53,Online Subscriptions,Technology and Services
2024-05-28,-15.6,UBER* TRIP,312.92,Transport,Living Expenses
2024-05-26,-5.08,SQ *ANTICO WOODFIRED P Pyrmont AU,328.52,Restaurants,Food
2024-05-26,-18.27,SQ *ANTICO WOODFIRED P Pyrmont AU,333.6,Restaurants,Food
2024-05-25,-13.2,OIDEN 11 PTY LTD SYDNEY AU AUS Card xx1037 Value Date: 23/05/2024,351.87,Restaurants,Food
2024-05-24,300.0,CASH DEPOSIT CBA ATM HAYMARKET A NSW 200601 AUS,365.07,Cash Deposit,Financial Transactions
2024-05-23,-1098.0,Direct Debit 505091 IGLU NO205 PTY 66935,65.07,Rent,Living Expenses
2024-05-23,-6.3,Sharetea Meriton T Sydney AU,1163.07,Food and Beverage,Food
2024-05-23,-21.74,SQ *ENJOY MIE Ultimo AU,1169.37,Restaurants,Food
2024-05-23,-8.8,STARBUCKS COFFEE B01 CHIPPENDALE AU,1191.11,Coffee,Food
2024-05-23,-4.0,LAT*IgluBroadway Chippindale AU AUS Card xx1037 Value Date: 20/05/2024,1199.91,Rent,Living Expenses
2024-05-23,-14.19,DidiChuxing DIDI MOBIL Sydney AU AUS Card xx1037 Value Date: 21/05/2024,1203.91,Transport,Living Expenses
2024-05-23,-12.8,DidiChuxing DIDI MOBIL Sydney AU AUS Card xx1037 Value Date: 21/05/2024,1218.1,Transport,Living Expenses
2024-05-23,-10.0,TRANSPORTFORNSW OPAL CHIPPENDALE AUS Card xx1037 Value Date: 22/05/2024,1230.9,Transport,Living Expenses
2024-05-22,-10.17,Fruitezy Pyrmont AU,1240.9,Grocery,Food
2024-05-22,-4.8,WOOLWORTHS 1905 SYDNEY AU AUS Card xx1037 Value Date: 20/05/2024,1251.07,Grocery,Food
2024-05-22,-4.0,LAT*IgluBroadway Chippindale AU AUS Card xx1037 Value Date: 20/05/2024,1255.87,Rent,Living Expenses
2024-05-22,-4.0,LAT*IgluBroadway Chippindale AU AUS Card xx1037 Value Date: 20/05/2024,1259.87,Rent,Living Expenses
2024-05-22,-4.0,LAT*IgluBroadway Chippindale AU AUS Card xx1037 Value Date: 20/05/2024,1263.87,Rent,Living Expenses
2024-05-22,-4.0,LAT*IgluBroadway Chippindale AU AUS Card xx1037 Value Date: 20/05/2024,1267.87,Rent,Living Expenses
2024-05-22,-4.0,LAT*IgluBroadway Chippindale AU AUS Card xx1037 Value Date: 20/05/2024,1271.87,Rent,Living Expenses
2024-05-22,-4.0,LAT*IgluBroadway Chippindale AU AUS Card xx1037 Value Date: 20/05/2024,1275.87,Rent,Living Expenses
2024-05-22,-4.0,LAT*IgluBroadway Chippindale AU AUS Card xx1037 Value Date: 20/05/2024,1279.87,Rent,Living Expenses
2024-05-22,-4.0,LAT*IgluBroadway Chippindale AU AUS Card xx1037 Value Date: 20/05/2024,1283.87,Rent,Living Expenses
2024-05-22,-4.0,LAT*IgluBroadway Chippindale AU AUS Card xx1037 Value Date: 20/05/2024,1287.87,Rent,Living Expenses
2024-05-22,-10.0,TRANSPORTFORNSW OPAL CHIPPENDALE AUS Card xx1037 Value Date: 20/05/2024,1291.87,Transport,Living Expenses
2024-05-22,-3.4,Provender Australia SilverwateNSWAU,1301.87,Vending Machine,Food
2024-05-22,-3.4,Provender Australia SilverwateNSWAU,1305.27,Vending Machine,Food
2024-05-21,-7.0,UNI OF SYDNEY UNION UNI OF SYDNEY NS AUS Card xx1037 Value Date: 17/05/2024,1308.67,Student Fees,Education
2024-05-21,-0.51,ENJOY MIE SYDNEY 02 AUS Card xx1037 Value Date: 19/05/2024,1315.67,Restaurants,Food
2024-05-21,-29.0,LANGUAGE ACADEMY NORTH KELLYVI NS AUS Card xx1037 Value Date: 19/05/2024,1316.18,Online Subscriptions,Technology and Services
2024-05-19,-4.2,Provender Australia SilverwateNSWAU,1345.18,Vending Machine,Food
2024-05-19,-4.2,Provender Australia SilverwateNSWAU,1349.38,Vending Machine,Food
2024-05-19,-4.2,Provender Australia SilverwateNSWAU,1353.58,Vending Machine,Food
2024-05-19,-21.74,SQ *ENJOY MIE Ultimo AU,1357.78,Restaurants,Food
2024-05-18,-4.57,SQ *ENJOY MIE Ultimo AU,1379.52,Restaurants,Food
2024-05-16,-5.07,Fruitezy Pyrmont AU,1384.09,Grocery,Food
2024-05-16,-9.04,DidiChuxing DIDI MOBIL Sydney AU AUS Card xx1037 Value Date: 14/05/2024,1389.16,Transport,Living Expenses
2024-05-16,-54.99,LinkedIn Pre 955536961 lnkd.in/bill AU AUS Card xx1037 Value Date: 14/05/2024,1398.2,Online Subscriptions,Technology and Services
2024-05-15,-21.74,SQ *ENJOY MIE Ultimo AU,1453.19,Restaurants,Food
2024-05-15,-4.0,LAT*IgluBroadway Chippindale AU AUS Card xx1037 Value Date: 10/05/2024,1474.93,Rent,Living Expenses
2024-05-15,-4.0,LAT*IgluBroadway Chippindale AU AUS Card xx1037 Value Date: 10/05/2024,1478.93,Rent,Living Expenses
2024-05-15,-4.0,LAT*IgluBroadway Chippindale AU AUS Card xx1037 Value Date: 10/05/2024,1482.93,Rent,Living Expenses
2024-05-15,-4.0,LAT*IgluBroadway Chippindale AU AUS Card xx1037 Value Date: 10/05/2024,1486.93,Rent,Living Expenses
2024-05-15,-16.67,OZEKI BOWL Sydney NS AUS Card xx1037 Value Date: 13/05/2024,1490.93,Restaurants,Food
2024-05-15,-4.49,APPLE.COM/BILL SYDNEY NS AUS Card xx1037 Value Date: 13/05/2024,1507.6,Apple,Technology and Services
2024-05-15,-121.2,MEDIBANK PHI DEBIT MELBOURNE AUS Card xx1037 Value Date: 13/05/2024,1512.09,Student Fees,Education
2024-05-14,-4.0,LAT*IgluBroadway Chippindale AU AUS Card xx1037 Value Date: 10/05/2024,1633.29,Rent,Living Expenses
2024-05-14,-4.0,LAT*IgluBroadway Chippindale AU AUS Card xx1037 Value Date: 10/05/2024,1637.29,Rent,Living Expenses
2024-05-14,-4.0,LAT*IgluBroadway Chippindale AU AUS Card xx1037 Value Date: 10/05/2024,1641.29,Rent,Living Expenses
2024-05-14,-4.0,LAT*IgluBroadway Chippindale AU AUS Card xx1037 Value Date: 10/05/2024,1645.29,Rent,Living Expenses
2024-05-14,-20.49,APPLE.COM/BILL SYDNEY NS AUS Card xx1037 Value Date: 10/05/2024,1649.29,Apple,Technology and Services
2024-05-14,-0.09,International Transaction Fee Value Date: 09/05/2024,1669.78,Student Fees,Education
2024-05-14,-2.84,Google Storage Mountain View CA USA Card xx1037 IDR 29859.00 Value Date: 09/05/2024,1669.87,Online Subscriptions,Technology and Services
2024-05-14,-1.37,International Transaction Fee Value Date: 12/05/2024,1672.71,Student Fees,Education
2024-05-14,-45.5,GRAMMARLY COVINNKW0 8883186146 CA USA Card xx1037 USD 30.00 Value Date: 12/05/2024,1674.08,Online Subscriptions,Technology and Services
2024-05-13,-7.12,Roll'd Westfield Sydney AU,1719.58,Restaurants,Food
2024-05-12,-10.15,Fruitezy Pyrmont AU,1726.7,Grocery,Food
2024-05-12,-5.07,Fruitezy Pyrmont AU,1736.85,Grocery,Food
2024-05-11,-6.27,Gelato Messina - SC Pyrmont AU,1741.92,Food and Beverage,Food
2024-05-11,-5.89,Kensington Investment Chippendale AU,1748.19,Rent,Living Expenses
2024-05-11,-15.76,Kensington Investment Chippendale AU,1754.08,Rent,Living Expenses
2024-05-11,-22.23,SWEET TOWN ON GEORGE HAYMARKET NS AUS Card xx1037 Value Date: 08/05/2024,1769.84,Restaurants,Food
2024-05-10,-44.4,SQ *ENJOY MIE Ultimo AU,1792.07,Restaurants,Food
2024-05-10,-9.4,WOOLWORTHS 1905 SYDNEY AU AUS Card xx1037 Value Date: 08/05/2024,1836.47,Grocery,Food
2024-05-10,-13.99,Spotify P2C0842D18 Sydney AU AUS Card xx1037 Value Date: 08/05/2024,1845.87,Online Subscriptions,Technology and Services
2024-05-10,-21.98,ENJOY MIE SYDNEY 02 AUS Card xx1037 Value Date: 08/05/2024,1859.86,Restaurants,Food
2024-05-09,-1098.0,Direct Debit 505091 IGLU NO205 PTY 66935,1881.84,Rent,Living Expenses
2024-05-09,-17.99,Canva* 04146-22217831,2979.84,Online Subscriptions,Technology and Services
2024-05-09,-32.88,Zhangliang spicy hotp Haymarket AU,2997.83,Restaurants,Food
2024-05-08,-8.8,STARBUCKS COFFEE B00 SYDNEY AU,3030.71,Coffee,Food
2024-05-08,-15.0,Overdraw Fee For exceeding available funds on 07 May,3039.51,Debit,Financial Transactions
2024-05-08,-35.0,TIMEZONE HAYMARKET AU Card xx1037,3054.51,Entertainment,Activities
2024-05-08,3185.0,IZMIRTA RACHMAN REF 2024050800012626,3089.51,Credit,Financial Transactions
2024-05-07,-123.68,Direct Debit 119218 Vodafone Aus A3-2a2d8308,-95.49,Mobile Services,Technology and Services
2024-05-07,-9.99,APPLE.COM/BILL SYDNEY NS AUS Card xx1037 Value Date: 03/05/2024,28.19,Apple,Technology and Services
2024-05-07,-72.25,Tickets*SUDATA x S BELROSE AU AUS Card xx1037 Value Date: 03/05/2024,38.18,Events,Activities
2024-05-07,-14.45,1342_Broadway_KFC Pyrmont AU AUS Card xx1037 Value Date: 03/05/2024,110.43,Restaurants,Food
2024-05-07,-20.7,ICC Darling Harbour Sydney NS AUS Card xx1037 Value Date: 05/05/2024,124.88,Entertainment,Activities
2024-05-07,-3.4,PROVENDER HOLDINGS AUS Waterloo AU AUS Card xx1037 Value Date: 05/05/2024,145.58,Vending Machine,Food
2024-05-05,-21.4,SQ *ENJOY MIE Ultimo AU,148.98,Restaurants,Food
2024-05-05,-3.4,Provender Australia SilverwateNSWAU,170.38,Vending Machine,Food
2024-05-05,-4.2,Provender Australia SilverwateNSWAU,173.78,Vending Machine,Food
2024-05-04,-5.08,Shalom Restaurant Sydney AU,177.98,Restaurants,Food
2024-05-04,-34.51,Shalom Restaurant Sydney AU,183.06,Restaurants,Food
2024-05-04,-20.7,ICC Darling Harbour Sydney NS AUS Card xx1037 Value Date: 02/05/2024,217.57,Entertainment,Activities
2024-05-04,-19.9,OZEKI BOWL Sydney NS AUS Card xx1037 Value Date: 02/05/2024,238.27,Restaurants,Food
2024-05-03,-4.59,SQ *ENJOY MIE Ultimo AU,258.17,Restaurants,Food
2024-05-03,-21.4,SQ *ENJOY MIE Ultimo AU,262.76,Restaurants,Food
2024-05-03,-13.99,CRUNCHYROLL *AUD 415-503-9235 CA USA Card xx1037 AUD 13.99 Value Date: 01/05/2024,284.16,Online Subscriptions,Technology and Services
2024-05-03,-14.5,XIN MEI FASHION SYDNEY NS AUS Card xx1037 Value Date: 01/05/2024,298.15,Shopping,Financial Transactions
2024-05-03,-29.99,ADOBE ADOBE.LY/ENAU AU AUS Card xx1037 Value Date: 01/05/2024,312.65,Online Subscriptions,Technology and Services
2024-05-02,-8.8,STARBUCKS COFFEE B01 CHIPPENDALE AU,342.64,Coffee,Food
2024-05-02,-59.99,APPLE.COM/BILL SYDNEY AU AUS Card xx1037 Value Date: 30/04/2024,351.44,Apple,Technology and Services
2024-05-01,-3.4,Provender Australia SilverwateNSWAU,411.43,Vending Machine,Food
2024-05-01,-4.2,Provender Australia SilverwateNSWAU,414.83,Vending Machine,Food
2024-05-01,-3.4,Provender Australia SilverwateNSWAU,419.03,Vending Machine,Food
2024-05-01,-15.76,Kensington Investment Chippendale AU,422.43,Rent,Living Expenses
2024-05-01,-21.8,SQ *ENJOY MIE Ultimo AU,438.19,Restaurants,Food
2024-04-30,-28.09,Zhangliang spicy hotp Haymarket AU,459.99,Restaurants,Food
2024-04-30,-0.46,International Transaction Fee Value Date: 26/04/2024,488.08,Student Fees,Education
2024-04-30,-15.41,WWW.SYMBOLAB.COM REDWOOD CITY CA USA Card xx1037 USD 9.99 Value Date: 26/04/2024,488.54,Online Subscriptions,Technology and Services
2024-04-30,-29.0,APPLE R523 BROADWAY ULTIMO NS AUS Card xx1037 Value Date: 26/04/2024,503.95,Apple,Technology and Services
2024-04-30,-12.99,APPLE.COM/BILL SYDNEY AU AUS Card xx1037 Value Date: 25/04/2024,532.95,Apple,Technology and Services
2024-04-30,-1.02,International Transaction Fee Value Date: 26/04/2024,545.94,Student Fees,Education
2024-04-30,-33.93,CHATGPT SUBSCRIPTION SAN FRANCISCO CA USA Card xx1037 USD 22.00 Value Date: 26/04/2024,546.96,Online Subscriptions,Technology and Services
2024-04-30,-24.04,ENJOY MIE SYDNEY 02 AUS Card xx1037 Value Date: 26/04/2024,580.89,Restaurants,Food
2024-04-30,-14.7,1342_Broadway_KFC Pyrmont AU AUS Card xx1037 Value Date: 26/04/2024,604.93,Restaurants,Food
2024-04-30,-46.01,PANCAKES ON THE ROCKS HAYMARKET AUS Card xx1037 Value Date: 25/04/2024,619.63,Restaurants,Food
2024-04-29,-41.47,FF Darling Harbour Sydney AU,665.64,Restaurants,Food
2024-04-28,-33.82,PEPPER LUNCH SYDNEY NSWAU,707.11,Restaurants,Food
2024-04-28,-7.5,ANDERSENS OF DENMARK ICE COOGEE NSW AU Card xx1037,740.93,Food and Beverage,Food
2024-04-28,-21.42,VE-SWEET PTY LTD LIDCOMBE NSW AU,748.43,Food and Beverage,Food
2024-04-27,-2.55,Zhangliang spicy hotp Haymarket AU,769.85,Restaurants,Food
2024-04-27,-24.28,Zhangliang spicy hotp Haymarket AU,772.4,Restaurants,Food
2024-04-27,-19.7,ICC Darling Harbour Sydney NS AUS Card xx1037 Value Date: 24/04/2024,796.68,Entertainment,Activities
2024-04-27,-0.23,International Transaction Fee Value Date: 24/04/2024,816.38,Student Fees,Education
2024-04-27,-7.77,A MEDIUM CORPORATION 4155085008 CA USA Card xx1037 USD 5.00 Value Date: 24/04/2024,816.61,Online Subscriptions,Technology and Services
2024-04-27,-47.0,SCRIMBA OSLO DU NOR Card xx1037 AUD 47.00 Value Date: 26/04/2024,824.38,Online Subscriptions,Technology and Services
2024-04-27,-10.0,TRANSPORTFORNSW OPAL CHIPPENDALE AUS Card xx1037 Value Date: 24/04/2024,871.38,Transport,Living Expenses
2024-04-26,-1098.0,Direct Debit 505091 IGLU NO205 PTY 66935,881.38,Rent,Living Expenses
2024-04-26,-0.5,SQ *ENJOY MIE Ultimo AU,1979.38,Restaurants,Food
2024-04-25,-10.5,TSG BROADWAY CHIPPENDALE NSW AU,1979.88,Food and Beverage,Food
2024-04-25,-6.84,STARBUCKS COFFEE B01 CHIPPENDALE AU,1990.38,Coffee,Food
2024-04-25,-15.8,ICC Darling Harbour Sydney NS AUS Card xx1037 Value Date: 23/04/2024,1997.22,Entertainment,Activities
2024-04-25,-23.01,ENJOY MIE SYDNEY 02 AUS Card xx1037 Value Date: 23/04/2024,2013.02,Restaurants,Food
2024-04-25,-21.48,APPLE.COM/BILL SYDNEY AU AUS Card xx1037 Value Date: 23/04/2024,2036.03,Apple,Technology and Services
2024-04-25,-4.5,PARRA GROUP PL PARRAMATTA AUS Card xx1037 Value Date: 22/04/2024,2057.51,Grocery,Food
2024-04-25,-10.0,TRANSPORTFORNSW OPAL CHIPPENDALE AUS Card xx1037 Value Date: 24/04/2024,2062.01,Transport,Living Expenses
2024-04-24,-12.19,SIBYS KEBAB AND PIDE P PARRAMATTA AU AUS Card xx1037 Value Date: 22/04/2024,2072.01,Grocery,Food
2024-04-24,-39.6,JORDANS SEAFOOD SYDNEY NS AUS Card xx1037 Value Date: 21/04/2024,2084.2,Restaurants,Food
2024-04-24,-18.25,PARRA GROUP PL PARRAMATTA AUS Card xx1037 Value Date: 22/04/2024,2123.8,Grocery,Food
2024-04-24,-1140.36,IGLU NO. 205 PTY LTD SYDNEY AUS Card xx1037 Value Date: 22/04/2024,2142.05,Rent,Living Expenses
2024-04-23,-45.0,UNI OF SYDNEY UNION,3282.41,Student Fees,Education
2024-04-23,-49.99,DYMOCKS SYDNEY SYDNEY AU,3327.41,Book,Education
2024-04-23,-28.3,MAPPEN 10 PTY LTD SYDNEY AU AUS Card xx1037 Value Date: 19/04/2024,3377.4,Restaurants,Food
2024-04-23,-13.95,1342_Broadway_KFC Pyrmont AU AUS Card xx1037 Value Date: 19/04/2024,3405.7,Restaurants,Food
2024-04-23,-11.95,1342_Broadway_KFC Pyrmont AU AUS Card xx1037 Value Date: 21/04/2024,3419.65,Restaurants,Food
2024-04-20,-9.0,TSG BROADWAY CHIPPENDALE NSW AU,3431.6,Food and Beverage,Food
2024-04-20,-29.33,HOLY BASIL DARLING SQUARE HAYMARK NSW AU Card xx1037,3440.6,Restaurants,Food
2024-04-20,-7.5,ANDERSENS OF DENMARK ICE COOGEE NSW AU Card xx1037,3469.93,Food and Beverage,Food
2024-04-20,-22.72,Zhangliang spicy hotp Haymarket AU,3477.43,Restaurants,Food
2024-04-20,-27.54,CONCRETE JUNGLE CHIPPENDALE NS AUS Card xx1037 Value Date: 18/04/2024,3500.15,Restaurants,Food
2024-04-19,-29.0,LANGUAGE ACADEMY,3527.69,Online Subscriptions,Technology and Services
2024-04-19,-8.08,NOODLES YOUR WAY SYDNEY AU AUS Card xx1037 Value Date: 17/04/2024,3556.69,Restaurants,Food
2024-04-18,-41.47,FF Darling Harbour Sydney AU,3564.77,Restaurants,Food
2024-04-18,-9.6,NOODLES YOUR WAY SYDNEY AU AUS Card xx1037 Value Date: 16/04/2024,3606.24,Restaurants,Food
2024-04-18,-21.9,SUSHI HUB BROADWAY HAYMARKET NS AUS Card xx1037 Value Date: 15/04/2024,3615.84,Restaurants,Food
2024-04-17,-3.0,Provender Australia SilverwateNSWAU,3637.74,Vending Machine,Food
2024-04-17,-17.69,Zhangliang spicy hotp Haymarket AU,3640.74,Restaurants,Food
2024-04-17,-5.3,STARBUCKS COFFEE B00 SYDNEY AU,3658.43,Coffee,Food
2024-04-17,-35.0,TIMEZONE HAYMARKET AU Card xx1037,3663.73,Entertainment,Activities
2024-04-17,3185.0,IZMIRTA RACHMAN REF 2024041700014309,3698.73,Credit,Financial Transactions
2024-04-17,-23.63,ENJOY MIE SYDNEY 02 AUS Card xx1037 Value Date: 15/04/2024,513.73,Restaurants,Food
2024-04-17,-21.21,SWEET TOWN ON GEORGE HAYMARKET NS AUS Card xx1037 Value Date: 14/04/2024,537.36,Restaurants,Food
2024-04-16,-8.8,STARBUCKS COFFEE B01 CHIPPENDALE AU,558.57,Coffee,Food
2024-04-16,-1.39,International Transaction Fee Value Date: 12/04/2024,567.37,Student Fees,Education
2024-04-16,-46.18,GRAMMARLY COMVNTKAE 8883186146 CA USA Card xx1037 USD 30.00 Value Date: 12/04/2024,568.76,Online Subscriptions,Technology and Services
2024-04-16,-28.2,MAPPEN 10 PTY LTD SYDNEY AU AUS Card xx1037 Value Date: 13/04/2024,614.94,Restaurants,Food
2024-04-16,-4.49,APPLE.COM/BILL SYDNEY NS AUS Card xx1037 Value Date: 13/04/2024,643.14,Apple,Technology and Services
2024-04-16,-54.99,LinkedIn Pre 945089543 lnkd.in/bill AU AUS Card xx1037 Value Date: 14/04/2024,647.63,Online Subscriptions,Technology and Services
2024-04-16,-22.91,ENJOY MIE SYDNEY 02 AUS Card xx1037 Value Date: 14/04/2024,702.62,Restaurants,Food
2024-04-15,-7.4,STARBUCKS COFFEE B01 CHIPPENDALE AU,725.53,Coffee,Food
2024-04-14,-8.2,STARBUCKS COFFEE B00 SYDNEY AU,732.93,Coffee,Food
2024-04-14,-15.4,MCDONALDS BROADWAY SYDNEY NSWAU,741.13,Restaurants,Food
2024-04-13,-4.0,LAT*IgluBroadway Chippindale AU AUS Card xx1037 Value Date: 11/04/2024,756.53,Rent,Living Expenses
2024-04-13,-4.0,LAT*IgluBroadway Chippindale AU AUS Card xx1037 Value Date: 11/04/2024,760.53,Rent,Living Expenses
2024-04-13,-4.0,LAT*IgluBroadway Chippindale AU AUS Card xx1037 Value Date: 11/04/2024,764.53,Rent,Living Expenses
2024-04-13,-4.0,LAT*IgluBroadway Chippindale AU AUS Card xx1037 Value Date: 11/04/2024,768.53,Rent,Living Expenses
2024-04-13,-121.2,MEDIBANK PHI DEBIT MELBOURNE AUS Card xx1037 Value Date: 11/04/2024,772.53,Student Fees,Education
2024-04-12,-21.33,Zhangliang spicy hotp Haymarket AU,893.73,Restaurants,Food
2024-04-12,-5.0,Unpaid Payment Fee Value Date: 11/04/2024,915.06,Debit,Financial Transactions
2024-04-12,1098.0,Return 11/04/24 Direct Debit 505091 IGLU NO205 PTY 66935 Value Date: 11/04/2024,920.06,Credit,Financial Transactions
2024-04-12,-21.5,GOLDEN TOWER P C PTY L HAYMARKET AU AUS Card xx1037 Value Date: 09/04/2024,-177.94,Restaurants,Food
2024-04-12,-0.09,International Transaction Fee Value Date: 09/04/2024,-156.44,Student Fees,Education
2024-04-12,-2.88,Google Storage Mountain View CA USA Card xx1037 IDR 29859.00 Value Date: 09/04/2024,-156.35,Online Subscriptions,Technology and Services
2024-04-12,-16.67,OZEKI BOWL Sydney NS AUS Card xx1037 Value Date: 10/04/2024,-153.47,Restaurants,Food
2024-04-11,-1098.0,Direct Debit 505091 IGLU NO205 PTY 66935,-136.8,Rent,Living Expenses
2024-04-11,-16.95,TSG BROADWAY CHIPPENDALE NSW AU,961.2,Food and Beverage,Food
2024-04-11,-14.73,Kensington Investment Chippendale AU,978.15,Rent,Living Expenses
2024-04-11,-16.44,ENJOY MIE SYDNEY 02 AUS Card xx1037 Value Date: 09/04/2024,992.88,Restaurants,Food
2024-04-10,-20.8,ZLR*It's time for Thai Haymarket AU,1009.32,Restaurants,Food
2024-04-10,-7.5,ANDERSENS OF DENMARK ICE COOGEE NSW AU Card xx1037,1030.12,Food and Beverage,Food
2024-04-10,-3.4,PROVENDER HOLDINGS AUS Waterloo AU AUS Card xx1037 Value Date: 07/04/2024,1037.62,Vending Machine,Food
2024-04-10,-3.0,PROVENDER HOLDINGS AUS Waterloo AU AUS Card xx1037 Value Date: 07/04/2024,1041.02,Vending Machine,Food
2024-04-09,-7.3,STARBUCKS COFFEE B00 SYDNEY AU,1044.02,Coffee,Food
2024-04-09,-17.99,Canva,1051.32,Online Subscriptions,Technology and Services
2024-04-09,-54.4,SUSHI HUB SYDNEY SYDNEY NS AUS Card xx1037 Value Date: 04/04/2024,1069.31,Restaurants,Food
2024-04-09,-22.91,ENJOY MIE SYDNEY 02 AUS Card xx1037 Value Date: 06/04/2024,1123.71,Restaurants,Food
2024-04-09,-21.98,ENJOY MIE SYDNEY 02 AUS Card xx1037 Value Date: 07/04/2024,1146.62,Restaurants,Food
2024-04-09,-12.99,Spotify P2B38CC728 Sydney AU AUS Card xx1037 Value Date: 07/04/2024,1168.6,Online Subscriptions,Technology and Services
2024-04-08,-3.0,SIXPROGRESSION PTY LTD ULTIMO NSW AU,1181.59,Restaurants,Food
2024-04-08,-21.8,SIXPROGRESSION PTY LTD ULTIMO NSW AU,1184.59,Restaurants,Food
2024-04-08,-8.5,STARBUCKS COFFEE B01 CHIPPENDALE AU,1206.39,Coffee,Food
2024-04-07,-3.4,Provender Australia SilverwateNSWAU,1214.89,Vending Machine,Food
2024-04-07,-7.5,ANDERSENS OF DENMARK ICE COOGEE NSW AU Card xx1037,1218.29,Food and Beverage,Food
2024-04-07,-3.4,Provender Australia SilverwateNSWAU,1225.79,Vending Machine,Food
2024-04-07,-3.4,Provender Australia SilverwateNSWAU,1229.19,Vending Machine,Food
2024-04-06,-8.2,STARBUCKS COFFEE B00 SYDNEY AU,1232.59,Coffee,Food
2024-04-05,-116.48,Direct Debit 119218 Vodafone Aus A3-29c789010,1240.79,Mobile Services,Technology and Services
2024-04-05,-43.49,FF Darling Harbour Sydney AU,1357.27,Restaurants,Food
2024-04-05,-9.99,APPLE.COM/BILL SYDNEY NS AUS Card xx1037 Value Date: 03/04/2024,1400.76,Apple,Technology and Services
2024-04-05,-7.5,ANDERSEN'S OF DENMAR COOGEE NS AUS Card xx1037 Value Date: 02/04/2024,1410.75,Food and Beverage,Food
2024-04-04,-12.12,NOODLES YOUR WAY SYDNEY AU AUS Card xx1037 Value Date: 02/04/2024,1418.25,Restaurants,Food
2024-04-04,-13.99,CRUNCHYROLL *AUD 415-503-9235 CA USA Card xx1037 AUD 13.99 Value Date: 02/04/2024,1430.37,Online Subscriptions,Technology and Services
2024-04-04,-39.99,COTTON ON MARKET CIT SYDNEY NS AUS Card xx1037 Value Date: 02/04/2024,1444.36,Shopping,Financial Transactions
2024-04-04,-80.0,AUTHENTICS FACTORY O HAYMARKET NS AUS Card xx1037 Value Date: 02/04/2024,1484.35,Shopping,Financial Transactions
2024-04-04,-25.4,TSG BROADWAY PTY LTD CHIPPENDALE AUS Card xx1037 Value Date: 30/03/2024,1564.35,Food and Beverage,Food
2024-04-04,-9.14,CARMEL DYER CONCESSI MAROUBRA NS AUS Card xx1037 Value Date: 31/03/2024,1589.75,Restaurants,Food
2024-04-04,-9.14,CARMEL DYER CONCESSI MAROUBRA NS AUS Card xx1037 Value Date: 31/03/2024,1598.89,Restaurants,Food
2024-04-03,-22.5,PMC GOLDEN TOWER PTY L HAYMARKET AU,1608.03,Restaurants,Food
2024-04-03,-28.3,MAPPEN 10 PTY LTD SYDNEY AU AUS Card xx1037 Value Date: 28/03/2024,1630.53,Restaurants,Food
2024-04-03,-4.0,LAT*IgluBroadway Chippindale AU AUS Card xx1037 Value Date: 28/03/2024,1658.83,Rent,Living Expenses
2024-04-03,-4.0,LAT*IgluBroadway Chippindale AU AUS Card xx1037 Value Date: 28/03/2024,1662.83,Rent,Living Expenses
2024-04-03,-4.0,LAT*IgluBroadway Chippindale AU AUS Card xx1037 Value Date: 28/03/2024,1666.83,Rent,Living Expenses
2024-04-03,-4.0,LAT*IgluBroadway Chippindale AU AUS Card xx1037 Value Date: 28/03/2024,1670.83,Rent,Living Expenses
2024-04-03,-4.0,LAT*IgluBroadway Chippindale AU AUS Card xx1037 Value Date: 28/03/2024,1674.83,Rent,Living Expenses
2024-04-03,-4.0,LAT*IgluBroadway Chippindale AU AUS Card xx1037 Value Date: 28/03/2024,1678.83,Rent,Living Expenses
2024-04-03,-47.35,ENJOY MIE SYDNEY 02 AUS Card xx1037 Value Date: 29/03/2024,1682.83,Restaurants,Food
2024-04-03,-14.0,Carvery Catering Carlton VI AUS Card xx1037 Value Date: 31/03/2024,1730.18,Restaurants,Food
2024-04-03,-33.48,APPLE.COM/BILL SYDNEY NS AUS Card xx1037 Value Date: 30/03/2024,1744.18,Apple,Technology and Services
2024-04-03,-7.5,ANDERSEN'S OF DENMAR COOGEE NS AUS Card xx1037 Value Date: 30/03/2024,1777.66,Food and Beverage,Food
2024-04-03,-36.57,RES*Sydney Royal East Sydney Olympi AU AUS Card xx1037 Value Date: 31/03/2024,1785.16,Events,Activities
2024-04-03,-95.5,TM *TICKETMASTERAU Melbourne AU AUS Card xx1037 Value Date: 29/03/2024,1821.73,Events,Activities
2024-04-03,-21.4,WOOLWORTHS 1905 SYDNEY AU AUS Card xx1037 Value Date: 01/04/2024,1917.23,Grocery,Food
2024-04-03,-29.99,ADOBE ADOBE.LY/ENAU AU AUS Card xx1037 Value Date: 01/04/2024,1938.63,Online Subscriptions,Technology and Services
2024-04-03,-10.0,TRANSPORTFORNSW OPAL CHIPPENDALE AUS Card xx1037 Value Date: 31/03/2024,1968.62,Transport,Living Expenses
2024-04-02,-8.8,STARBUCKS COFFEE B01 CHIPPENDALE AU,1978.62,Coffee,Food
2024-04-01,-35.37,Zhangliang spicy hotp Haymarket AU,1987.42,Restaurants,Food
2024-04-01,-9.43,STARBUCKS COFFEE B00 SYDNEY AU,2022.79,Coffee,Food
2024-03-31,45.0,Fast Transfer From ALTAF DIKRI Ticket Easter Show,2032.22,Credit,Financial Transactions
2024-03-31,-30.45,NXT*Easter Show Sendrat CarnegieVI AU,1987.22,Events,Activities
2024-03-31,-36.54,NXT*Easter Show Sendrat CarnegieVI AU,2017.67,Events,Activities
2024-03-31,-19.28,SQ *BIANCO DOME Sydney Olympi AU,2054.21,Events,Activities
2024-03-31,-18.27,SQ *ACE ATTRACTIONS Sydney Olympi AU,2073.49,Events,Activities
2024-03-31,-14.0,SQ *SPECIAL EVENTS & V Sydney Olympi AU,2091.76,Events,Activities
2024-03-30,-60.1,HURRICANES GRILL CIRCU SYDNEY AU Card xx1037,2105.76,Restaurants,Food
2024-03-29,-25.26,Zhangliang spicy hotp Haymarket AU,2165.86,Restaurants,Food
2024-03-29,-30.0,SQ *PEKO PEKO ?????? Darlington NS AUS Card xx1037 Value Date: 27/03/2024,2191.12,Restaurants,Food
2024-03-28,-15.4,MCDONALDS BROADWAY SYDNEY NSWAU Value Date: 29/03/2024,2221.12,Restaurants,Food
2024-03-28,-1098.0,Direct Debit 505091 IGLU NO205 PTY 66935,2236.52,Rent,Living Expenses
2024-03-28,-26.3,MAPPEN 10 PTY LTD SYDNEY AU AUS Card xx1037 Value Date: 26/03/2024,3334.52,Restaurants,Food
2024-03-28,-0.46,International Transaction Fee Value Date: 26/03/2024,3360.82,Student Fees,Education
2024-03-28,-15.36,WWW.SYMBOLAB.COM REDWOOD CITY CA USA Card xx1037 USD 9.99 Value Date: 26/03/2024,3361.28,Online Subscriptions,Technology and Services
2024-03-28,-15.4,TB_Haymarket_3114 Pyrmont AU AUS Card xx1037 Value Date: 26/03/2024,3376.64,Restaurants,Food
2024-03-28,-3.4,PROVENDER HOLDINGS AUS Waterloo AU AUS Card xx1037 Value Date: 25/03/2024,3392.04,Vending Machine,Food
2024-03-28,-169.0,JB HI FI STRAND ARCA SYDNEY NS AUS Card xx1037 Value Date: 25/03/2024,3395.44,Shopping,Financial Transactions
2024-03-28,-21.48,APPLE.COM/BILL SYDNEY AU AUS Card xx1037 Value Date: 25/03/2024,3564.44,Apple,Technology and Services
2024-03-28,-1.01,International Transaction Fee Value Date: 26/03/2024,3585.92,Student Fees,Education
2024-03-28,-33.82,CHATGPT SUBSCRIPTION SAN FRANCISCO CA USA Card xx1037 USD 22.00 Value Date: 27/03/2024,3586.93,Online Subscriptions,Technology and Services
2024-03-27,-7.9,STARBUCKS COFFEE B01 CHIPPENDALE AU,3620.75,Coffee,Food
2024-03-27,-75.0,FRIENDS & FAMILY SALONS CHIPPENDA NSW AU,3628.65,Salon,Personal Care
2024-03-27,-47.0,SCRIMBA OSLO DU NOR Card xx1037 AUD 47.00 Value Date: 26/03/2024,3703.65,Online Subscriptions,Technology and Services
2024-03-26,-7.9,STARBUCKS COFFEE B01 CHIPPENDALE AU,3750.65,Coffee,Food
2024-03-26,3225.0,IZMIRTA RACHMAN REF 2024032600012378,3758.55,Credit,Financial Transactions
2024-03-26,-20.05,HUNGER KEBAB PTY LTD ULTIMO NS AUS Card xx1037 Value Date: 21/03/2024,533.55,Restaurants,Food
2024-03-26,-13.11,SMP*Mae Ong Thai Glebe AU AUS Card xx1037 Value Date: 23/03/2024,553.6,Restaurants,Food
2024-03-26,-3.03,OFF BROADWAY HOTEL Ultimo AU AUS Card xx1037 Value Date: 23/03/2024,566.71,Food and Beverage,Food
2024-03-26,-3.03,OFF BROADWAY HOTEL Ultimo AU AUS Card xx1037 Value Date: 23/03/2024,569.74,Food and Beverage,Food
2024-03-26,-3.4,PROVENDER HOLDINGS AUS Waterloo AU AUS Card xx1037 Value Date: 24/03/2024,572.77,Vending Machine,Food
2024-03-26,-0.23,International Transaction Fee Value Date: 24/03/2024,576.17,Student Fees,Education
2024-03-26,-7.68,A MEDIUM CORPORATION 4155085008 CA USA Card xx1037 USD 5.00 Value Date: 25/03/2024,576.4,Online Subscriptions,Technology and Services
2024-03-25,-3.4,Provender Australia SilverwateNSWAU,584.08,Vending Machine,Food
2024-03-25,-3.0,Provender Australia SilverwateNSWAU,587.48,Vending Machine,Food
2024-03-25,-7.5,ROYAL COPENHAGEN CIR SYDNEY AU Card xx1037,590.48,Food and Beverage,Food
2024-03-25,-43.49,FF Darling Harbour Sydney AU,597.98,Restaurants,Food
2024-03-24,-7.9,STARBUCKS COFFEE B00 SYDNEY AU,641.47,Coffee,Food
2024-03-24,-7.9,STARBUCKS COFFEE B01 CHIPPENDALE AU,649.37,Coffee,Food
2024-03-24,-14.73,Kensington Investment Chippendale AU,657.27,Rent,Living Expenses
2024-03-24,-3.4,Provender Australia SilverwateNSWAU,672.0,Vending Machine,Food
2024-03-24,-3.4,Provender Australia SilverwateNSWAU,675.4,Vending Machine,Food
2024-03-23,-3.0,Provender Australia SilverwateNSWAU,678.8,Vending Machine,Food
2024-03-23,-35.0,TIMEZONE HAYMARKET AU Card xx1037,681.8,Entertainment,Activities
2024-03-23,-7.9,STARBUCKS COFFEE B00 SYDNEY AU,716.8,Coffee,Food
2024-03-22,-15.4,TB_Haymarket_3114 Pyrmont AU AUS Card xx1037 Value Date: 20/03/2024,724.7,Restaurants,Food
2024-03-22,-23.01,ENJOY MIE SYDNEY 02 AUS Card xx1037 Value Date: 20/03/2024,740.1,Restaurants,Food
2024-03-21,-30.74,PEPPER LUNCH SYDNEY NSWAU,763.11,Restaurants,Food
2024-03-21,-14.9,TB_Haymarket_3114 Pyrmont AU AUS Card xx1037 Value Date: 19/03/2024,793.85,Restaurants,Food
2024-03-21,-20.05,HUNGER KEBAB PTY LTD ULTIMO NS AUS Card xx1037 Value Date: 18/03/2024,808.75,Restaurants,Food
2024-03-21,-20.96,ENJOY MIE SYDNEY 02 AUS Card xx1037 Value Date: 19/03/2024,828.8,Restaurants,Food
2024-03-20,-21.21,SWEET TOWN ON GEORGE HAYMARKET NS AUS Card xx1037 Value Date: 16/03/2024,849.76,Restaurants,Food
2024-03-20,-11.0,TSG BROADWAY PTY LTD CHIPPENDALE AUS Card xx1037 Value Date: 16/03/2024,870.97,Food and Beverage,Food
2024-03-19,-29.0,LANGUAGE ACADEMY,881.97,Online Subscriptions,Technology and Services
2024-03-19,-14.9,TB_Haymarket_3114 Pyrmont AU AUS Card xx1037 Value Date: 15/03/2024,910.97,Restaurants,Food
2024-03-19,-28.25,ENJOY MIE SYDNEY 02 AUS Card xx1037 Value Date: 15/03/2024,925.87,Restaurants,Food
2024-03-17,-15.2,MCDONALDS BROADWAY SYDNEY NSWAU,954.12,Restaurants,Food
2024-03-17,-28.38,Zhangliang spicy hotp Haymarket AU,969.32,Restaurants,Food
2024-03-16,-14.9,TB_Haymarket_3114 Pyrmont AU AUS Card xx1037 Value Date: 14/03/2024,997.7,Restaurants,Food
2024-03-16,-54.99,LinkedIn Pre 933640970 lnkd.in/bill AU AUS Card xx1037 Value Date: 14/03/2024,1012.6,Online Subscriptions,Technology and Services
2024-03-16,-24.14,ENJOY MIE SYDNEY 02 AUS Card xx1037 Value Date: 13/03/2024,1067.59,Restaurants,Food
2024-03-16,-27.53,ENJOY MIE SYDNEY 02 AUS Card xx1037 Value Date: 14/03/2024,1091.73,Restaurants,Food
2024-03-15,-4.49,APPLE.COM/BILL SYDNEY NS AUS Card xx1037 Value Date: 13/03/2024,1119.26,Apple,Technology and Services
2024-03-14,-1098.0,Direct Debit 505091 IGLU NO205 PTY 66935,1123.75,Rent,Living Expenses
2024-03-14,-9.15,HQD TOBACCO STATION PT HAYMARKET AU AUS Card xx1037 Value Date: 11/03/2024,2221.75,Food and Beverage,Food
2024-03-14,-1.37,International Transaction Fee Value Date: 12/03/2024,2230.9,Student Fees,Education
2024-03-14,-45.5,GRAMMARLY CO7LUX4XN 8883186146 CA USA Card xx1037 USD 30.00 Value Date: 12/03/2024,2232.27,Online Subscriptions,Technology and Services
2024-03-13,-13.13,Andiamo Kensington St Chippendale AU,2277.77,Restaurants,Food
2024-03-13,-19.54,HUNGER KEBAB PTY LTD ULTIMO NS AUS Card xx1037 Value Date: 10/03/2024,2290.9,Restaurants,Food
2024-03-13,-198.0,UNIVERSITY OF SYDNEY UNIVERSITY OF NS AUS Card xx1037 Value Date: 08/03/2024,2310.44,Student Fees,Education
2024-03-13,-113.0,MEDIBANK PHI DEBIT MELBOURNE AUS Card xx1037 Value Date: 11/03/2024,2508.44,Student Fees,Education
2024-03-13,-16.3,SUSHI HUB BROADWAY HAYMARKET NS AUS Card xx1037 Value Date: 11/03/2024,2621.44,Restaurants,Food
2024-03-13,-16.3,SUSHI HUB BROADWAY HAYMARKET NS AUS Card xx1037 Value Date: 10/03/2024,2637.74,Restaurants,Food
2024-03-13,-15.2,MCDONALDS BROADWAY SYDNEY NSWAU,2654.04,Restaurants,Food
2024-03-12,-48.55,FF Darling Harbour Sydney AU,2669.24,Restaurants,Food
2024-03-12,-0.09,International Transaction Fee Value Date: 09/03/2024,2717.79,Student Fees,Education
2024-03-12,-2.9,Google Storage Mountain View CA USA Card xx1037 IDR 29859.00 Value Date: 09/03/2024,2717.88,Online Subscriptions,Technology and Services
2024-03-12,-21.81,PANCAKES ON THE ROCKS HAYMARKET NS AUS Card xx1037 Value Date: 10/03/2024,2720.78,Restaurants,Food
2024-03-12,-7.5,ANDERSEN'S OF DENMAR COOGEE NS AUS Card xx1037 Value Date: 09/03/2024,2742.59,Food and Beverage,Food
2024-03-12,-10.0,TRANSPORTFORNSW OPAL CHIPPENDALE AUS Card xx1037 Value Date: 09/03/2024,2750.09,Transport,Living Expenses
2024-03-11,-43.49,FF Darling Harbour Sydney AU,2760.09,Restaurants,Food
2024-03-10,-3.0,Provender Australia SilverwateNSWAU,2803.58,Vending Machine,Food
2024-03-09,-6.0,Transfer To - SUMARTO PayID Phone from CommBank App Payment Farros,2806.58,Events,Activities
2024-03-09,-17.99,Canva,2812.58,Online Subscriptions,Technology and Services
2024-03-09,-13.95,TB_Haymarket_3114 Pyrmont AU AUS Card xx1037 Value Date: 07/03/2024,2830.57,Restaurants,Food
2024-03-09,-12.99,Spotify P2A68C86F3 Sydney AU AUS Card xx1037 Value Date: 07/03/2024,2844.52,Online Subscriptions,Technology and Services
2024-03-08,-100.0,SQ *TEENAGE FAN CLUB Sydney AU,2857.51,Events,Activities
2024-03-08,-14.7,STARBUCKS COFFEE B01 CHIPPENDALE AU,2957.51,Coffee,Food
2024-03-08,-21.11,Hakatamon Ramen Haymarket AU,2972.21,Restaurants,Food
2024-03-08,-19.1,SUSHI HUB BROADWAY HAYMARKET NS AUS Card xx1037 Value Date: 06/03/2024,2993.32,Restaurants,Food
2024-03-08,-106.0,TICKETEK PTY LTD WEB SYDNEY AUS Card xx1037 Value Date: 07/03/2024,3012.42,Events,Activities
2024-03-07,-7.9,STARBUCKS COFFEE B00 SYDNEY AU,3118.42,Coffee,Food
2024-03-07,-5.89,Kensington Investment Chippendale AU,3126.32,Rent,Living Expenses
2024-03-07,-14.73,Kensington Investment Chippendale AU,3132.21,Rent,Living Expenses
2024-03-06,-116.48,Direct Debit 119218 Vodafone Aus A3-295841015,3146.94,Mobile Services,Technology and Services
2024-03-06,-15.16,SQ *JOE'S ICE CREAM The Rocks AU,3263.42,Food and Beverage,Food
2024-03-06,-38.44,FF Darling Harbour Sydney AU,3278.58,Restaurants,Food
2024-03-06,-8.45,TSG BROADWAY PTY LTD CHIPPENDALE AUS Card xx1037 Value Date: 02/03/2024,3317.02,Food and Beverage,Food
2024-03-06,-3.0,Provender Australia SilverwateNSWAU,3325.47,Vending Machine,Food
2024-03-06,-3.4,Provender Australia SilverwateNSWAU,3328.47,Vending Machine,Food
2024-03-06,-3.4,Provender Australia SilverwateNSWAU,3331.87,Vending Machine,Food
2024-03-05,-7.9,STARBUCKS COFFEE B01 CHIPPENDALE AU,3335.27,Coffee,Food
2024-03-05,-37.43,FF Darling Harbour Sydney AU,3343.17,Restaurants,Food
2024-03-05,3185.0,IZMIRTA RACHMAN REF 2024030500007738,3380.6,Credit,Financial Transactions
2024-03-05,-13.99,CRUNCHYROLL *AUD 415-503-9235 CA USA Card xx1037 AUD 13.99 Value Date: 01/03/2024,195.6,Online Subscriptions,Technology and Services
2024-03-05,-21.9,SUSHI HUB BROADWAY HAYMARKET NS AUS Card xx1037 Value Date: 01/03/2024,209.59,Restaurants,Food
2024-03-05,-27.5,Cellini's Sydney NS AUS Card xx1037 Value Date: 02/03/2024,231.49,Restaurants,Food
2024-03-05,-29.99,ADOBE SYSTEMS PTY LTD SYDNEY AU AUS Card xx1037 Value Date: 01/03/2024,258.99,Online Subscriptions,Technology and Services
2024-03-05,-13.45,TB_Haymarket_3114 Pyrmont AU AUS Card xx1037 Value Date: 02/03/2024,288.98,Restaurants,Food
2024-03-05,-9.6,NOODLES YOUR WAY SYDNEY AU AUS Card xx1037 Value Date: 03/03/2024,302.43,Restaurants,Food
2024-03-05,-13.45,TB_Haymarket_3114 Pyrmont AU AUS Card xx1037 Value Date: 03/03/2024,312.03,Restaurants,Food
2024-03-05,-7.5,ANDERSEN'S OF DENMAR COOGEE NS AUS Card xx1037 Value Date: 02/03/2024,325.48,Food and Beverage,Food
2024-03-05,-9.99,APPLE.COM/BILL SYDNEY AU AUS Card xx1037 Value Date: 03/03/2024,332.98,Apple,Technology and Services
2024-03-04,-18.18,Andiamo Kensington St Chippendale AU,342.97,Restaurants,Food
2024-03-03,-7.9,STARBUCKS COFFEE B01 CHIPPENDALE AU,361.15,Coffee,Food
2024-03-03,-35.0,TIMEZONE HAYMARKET AU Card xx1037,369.05,Entertainment,Activities
2024-03-02,-13.95,TB_Haymarket_3114 Pyrmont AU AUS Card xx1037 Value Date: 29/02/2024,404.05,Restaurants,Food
2024-03-02,-48.47,APPLE.COM/BILL SYDNEY NS AUS Card xx1037 Value Date: 29/02/2024,418.0,Apple,Technology and Services
2024-03-02,-7.5,ANDERSEN'S OF DENMAR COOGEE NS AUS Card xx1037 Value Date: 28/02/2024,466.47,Food and Beverage,Food
2024-03-01,-23.25,SQ *ENJOY MIE Sydney AU,473.97,Restaurants,Food
2024-03-01,-15.0,APPLE R238 SYDNEY SYDNEY NS AUS Card xx1037 Value Date: 28/02/2024,497.22,Apple,Technology and Services
2024-03-01,-7.5,ANDERSEN'S OF DENMAR COOGEE NS AUS Card xx1037 Value Date: 27/02/2024,512.22,Food and Beverage,Food
2024-02-29,-1098.0,Direct Debit 505091 IGLU NO205 PTY 66935,519.72,Rent,Living Expenses
2024-02-29,-7.9,STARBUCKS COFFEE B01 CHIPPENDALE AU,1617.72,Coffee,Food
2024-02-29,-7.5,ANDERSEN'S OF DENMAR COOGEE NS AUS Card xx1037 Value Date: 26/02/2024,1625.62,Food and Beverage,Food
2024-02-28,-37.5,Transfer To Praddeep CommBank App Payment recording farros,1633.12,Events,Activities
2024-02-28,-21.8,SIXPROGRESSION PTY LTD ULTIMO NSW AU,1670.62,Restaurants,Food
2024-02-28,-0.46,International Transaction Fee Value Date: 26/02/2024,1692.42,Student Fees,Education
2024-02-28,-15.28,WWW.SYMBOLAB.COM REDWOOD CITY CA USA Card xx1037 USD 9.99 Value Date: 26/02/2024,1692.88,Online Subscriptions,Technology and Services
2024-02-28,-4.0,ANDERSEN'S OF DENMAR COOGEE NS AUS Card xx1037 Value Date: 25/02/2024,1708.16,Food and Beverage,Food
2024-02-28,-1.01,International Transaction Fee Value Date: 26/02/2024,1712.16,Student Fees,Education
2024-02-28,-33.64,CHATGPT SUBSCRIPTION SAN FRANCISCO CA USA Card xx1037 USD 22.00 Value Date: 27/02/2024,1713.17,Online Subscriptions,Technology and Services
2024-02-28,-24.14,LIV*ENJOY MIE SYDNEY AU AUS Card xx1037 Value Date: 26/02/2024,1746.81,Restaurants,Food
2024-02-28,-11.0,TSG BROADWAY PTY LTD CHIPPENDALE AUS Card xx1037 Value Date: 25/02/2024,1770.95,Food and Beverage,Food
2024-02-28,-2.0,AU-RANGE DUTY FREE P KATOOMBA NS AUS Card xx1037 Value Date: 24/02/2024,1781.95,Events,Activities
2024-02-27,-62.0,IM ANGUS COCKLE BAY PTY L SYDNEY NSW AU Card xx1037,1783.95,Restaurants,Food
2024-02-27,-35.37,UBER *TRIP Sydney AU AUS Card xx1037 Value Date: 23/02/2024,1845.95,Transport,Living Expenses
2024-02-27,-7.5,ANDERSEN'S OF DENMAR COOGEE NS AUS Card xx1037 Value Date: 23/02/2024,1881.32,Food and Beverage,Food
2024-02-27,-0.23,International Transaction Fee Value Date: 24/02/2024,1888.82,Student Fees,Education
2024-02-27,-7.65,A MEDIUM CORPORATION 4155085008 CA USA Card xx1037 USD 5.00 Value Date: 25/02/2024,1889.05,Online Subscriptions,Technology and Services
2024-02-27,-27.5,Cellini's Sydney NS AUS Card xx1037 Value Date: 25/02/2024,1896.7,Restaurants,Food
2024-02-27,-47.0,SCRIMBA OSLO DU NOR Card xx1037 AUD 47.00 Value Date: 26/02/2024,1924.2,Online Subscriptions,Technology and Services
2024-02-25,-17.0,SQ *PIRHANA FISH CO Pyrmont AU,1971.2,Restaurants,Food
2024-02-25,-30.0,Transfer To Praddeep CommBank App Payment Farros,1988.2,Events,Activities
2024-02-24,-21.8,SIXPROGRESSION PTY LTD ULTIMO NSW AU,2018.2,Restaurants,Food
2024-02-24,-62.5,Transfer To Praddeep CommBank App Payment Farros,2040.0,Events,Activities
2024-02-24,-13.0,THE LOOKOUT @ ECHO POI KATOOMBA AU Card xx1037,2102.5,Events,Activities
2024-02-24,-4.0,LAT*IgluBroadway Chippindale AU AUS Card xx1037 Value Date: 22/02/2024,2115.5,Rent,Living Expenses
2024-02-24,-4.0,LAT*IgluBroadway Chippindale AU AUS Card xx1037 Value Date: 22/02/2024,2119.5,Rent,Living Expenses
2024-02-24,-6.49,APPLE.COM/BILL SYDNEY AU AUS Card xx1037 Value Date: 22/02/2024,2123.5,Apple,Technology and Services
2024-02-23,-23.25,SQ *ENJOY MIE Sydney AU,2129.99,Restaurants,Food
2024-02-23,-16.3,SUSHI HUB BROADWAY HAYMARKET NS AUS Card xx1037 Value Date: 21/02/2024,2153.24,Restaurants,Food
2024-02-23,-10.0,TRANSPORTFORNSW OPAL CHIPPENDALE AUS Card xx1037 Value Date: 22/02/2024,2169.54,Transport,Living Expenses
2024-02-22,-12.0,KELLYS ON KING NEWTOWN AU Card xx1037,2179.54,Events,Activities
2024-02-22,-24.8,SIXPROGRESSION PTY LTD ULTIMO NSW AU,2191.54,Restaurants,Food
2024-02-22,-7.9,STARBUCKS COFFEE B00 SYDNEY AU,2216.34,Coffee,Food
2024-02-22,-25.43,THE SAMBAL SYDNEY NS AUS Card xx1037 Value Date: 20/02/2024,2224.24,Restaurants,Food
2024-02-21,-7.9,STARBUCKS COFFEE B00 SYDNEY AU,2249.67,Coffee,Food
2024-02-21,-24.8,SIXPROGRESSION PTY LTD ULTIMO NSW AU,2257.57,Restaurants,Food
2024-02-21,-445.01,WL *VUE* TESTING EXAM BLOOMINGTON MN USA Card xx1037 AUD 445.01 Value Date: 18/02/2024,2282.37,Student Fees,Education
2024-02-20,-12.12,Andiamo Kensington St Chippendale AU,2727.38,Restaurants,Food
2024-02-19,-15.2,MCDONALDS BROADWAY SYDNEY NSWAU,2739.5,Restaurants,Food
2024-02-19,-29.0,LANGUAGE ACADEMY,2754.7,Online Subscriptions,Technology and Services
2024-02-19,-27.33,SQ *ENJOY MIE Sydney AU,2783.7,Restaurants,Food
2024-02-19,-9.0,IGLU NO. 205 PTY LTD CHIPPENDALE NSW AU,2811.03,Rent,Living Expenses
2024-02-18,-7.9,STARBUCKS COFFEE B00 SYDNEY AU,2820.03,Coffee,Food
2024-02-18,-21.0,SQ *UMMA KITCHEN SYDNE Sydney AU,2827.93,Restaurants,Food
2024-02-17,-7.9,STARBUCKS COFFEE B00 SYDNEY AU,2848.93,Coffee,Food
2024-02-17,-24.8,SIXPROGRESSION PTY LTD ULTIMO NSW AU,2856.83,Restaurants,Food
2024-02-17,-4.0,LAT*IgluBroadway Chippindale AU AUS Card xx1037 Value Date: 15/02/2024,2881.63,Rent,Living Expenses
2024-02-17,-4.0,LAT*IgluBroadway Chippindale AU AUS Card xx1037 Value Date: 15/02/2024,2885.63,Rent,Living Expenses
2024-02-17,-10.32,DidiChuxing DIDI MOBIL Sydney AU AUS Card xx1037 Value Date: 15/02/2024,2889.63,Transport,Living Expenses
2024-02-17,-18.95,WOOLWORTHS 1905 SYDNEY AU AUS Card xx1037 Value Date: 15/02/2024,2899.95,Grocery,Food
2024-02-16,-21.0,SLIMS QUALITY BURGER SYDNEY AU Card xx1037,2918.9,Restaurants,Food
2024-02-16,-13.9,STARBUCKS COFFEE B01 CHIPPENDALE AU,2939.9,Coffee,Food
2024-02-16,-54.99,LinkedIn Pre 922066977 lnkd.in/bill AU AUS Card xx1037 Value Date: 14/02/2024,2953.8,Online Subscriptions,Technology and Services
2024-02-16,-21.6,SUSHI HUB BROADWAY HAYMARKET NS AUS Card xx1037 Value Date: 14/02/2024,3008.79,Restaurants,Food
2024-02-15,-1098.0,Direct Debit 505091 IGLU NO205 PTY 66935,3030.39,Rent,Living Expenses
2024-02-15,-13.0,KELLYS ON KING NEWTOWN AU Card xx1037,4128.39,Events,Activities
2024-02-15,-18.0,KELLYS ON KING NEWTOWN AU Card xx1037,4141.39,Events,Activities
2024-02-15,-10.0,KELLYS ON KING NEWTOWN AU Card xx1037,4159.39,Events,Activities
2024-02-15,-24.8,SIXPROGRESSION PTY LTD ULTIMO NSW AU,4169.39,Restaurants,Food
2024-02-15,-21.47,LIV*ENJOY MIE SYDNEY AU AUS Card xx1037 Value Date: 13/02/2024,4194.19,Restaurants,Food
2024-02-15,-4.49,APPLE.COM/BILL SYDNEY AU AUS Card xx1037 Value Date: 13/02/2024,4215.66,Apple,Technology and Services
2024-02-14,-16.12,SMP*Talays Thai Seafoo Chippendale02 AU,4220.15,Restaurants,Food
2024-02-14,-17.68,ZLR*Uni Bros Kebabs Darlington AU,4236.27,Restaurants,Food
2024-02-14,-20.0,SQ *SYDNEY UNIVERSITY Forest Lodge AU,4253.95,Student Fees,Education
2024-02-14,3085.0,IZMIRTA RACHMAN REF 2024021400009599,4273.95,Credit,Financial Transactions
2024-02-14,-4.0,LAT*IgluBroadway Chippindale AU AUS Card xx1037 Value Date: 10/02/2024,1188.95,Rent,Living Expenses
2024-02-14,-4.0,LAT*IgluBroadway Chippindale AU AUS Card xx1037 Value Date: 10/02/2024,1192.95,Rent,Living Expenses
2024-02-14,-4.0,LAT*IgluBroadway Chippindale AU AUS Card xx1037 Value Date: 10/02/2024,1196.95,Rent,Living Expenses
2024-02-14,-4.0,LAT*IgluBroadway Chippindale AU AUS Card xx1037 Value Date: 10/02/2024,1200.95,Rent,Living Expenses
2024-02-14,-1.39,International Transaction Fee Value Date: 12/02/2024,1204.95,Student Fees,Education
2024-02-14,-46.27,GRAMMARLY COPSHB9EM 8883186146 CA USA Card xx1037 USD 30.00 Value Date: 12/02/2024,1206.34,Online Subscriptions,Technology and Services
2024-02-14,-20.9,ZAN Asian Cuisine Sydney NS AUS Card xx1037 Value Date: 12/02/2024,1252.61,Restaurants,Food
2024-02-14,-113.0,MEDIBANK PHI DEBIT MELBOURNE AUS Card xx1037 Value Date: 12/02/2024,1273.51,Student Fees,Education
2024-02-14,-19.1,SUSHI HUB BROADWAY HAYMARKET NS AUS Card xx1037 Value Date: 11/02/2024,1386.51,Restaurants,Food
2024-02-14,-16.3,SUSHI HUB BROADWAY HAYMARKET NS AUS Card xx1037 Value Date: 10/02/2024,1405.61,Restaurants,Food
2024-02-13,-13.8,OZT*PARTY @ MANNING,1421.91,Events,Activities
2024-02-13,-25.9,ZAN Asian Cuisine Sydney NS AUS Card xx1037 Value Date: 09/02/2024,1435.71,Restaurants,Food
2024-02-13,-7.5,ANDERSEN'S OF DENMAR COOGEE NS AUS Card xx1037 Value Date: 08/02/2024,1461.61,Food and Beverage,Food
2024-02-13,-0.09,International Transaction Fee Value Date: 09/02/2024,1469.11,Student Fees,Education
2024-02-13,-2.95,Google Storage Mountain View CA USA Card xx1037 IDR 29859.00 Value Date: 09/02/2024,1469.2,Online Subscriptions,Technology and Services
2024-02-13,-20.49,APPLE.COM/BILL SYDNEY AU AUS Card xx1037 Value Date: 09/02/2024,1472.15,Apple,Technology and Services
2024-02-13,-19.1,SUSHI HUB BROADWAY HAYMARKET NS AUS Card xx1037 Value Date: 09/02/2024,1492.64,Restaurants,Food
2024-02-13,-16.84,DidiChuxing DIDI MOBIL Sydney AU AUS Card xx1037 Value Date: 10/02/2024,1511.74,Transport,Living Expenses
2024-02-13,-29.68,DidiChuxing DIDI MOBIL Sydney AU AUS Card xx1037 Value Date: 11/02/2024,1528.58,Transport,Living Expenses
2024-02-13,-10.0,TRANSPORTFORNSW OPAL CHIPPENDALE AUS Card xx1037 Value Date: 10/02/2024,1558.26,Transport,Living Expenses
2024-02-12,-7.1,STARBUCKS COFFEE B00 SYDNEY AU,1568.26,Coffee,Food
2024-02-10,-17.1,Nene Chicken George Sydney AU,1575.36,Restaurants,Food
2024-02-10,-10.0,UNI OF SYDNEY UNION THE UNIVERSIT NS AUS Card xx1037 Value Date: 07/02/2024,1592.46,Student Fees,Education
2024-02-10,-23.01,LIV*ENJOY MIE SYDNEY AU AUS Card xx1037 Value Date: 08/02/2024,1602.46,Restaurants,Food
2024-02-09,-13.13,Andiamo Kensington St Chippendale AU,1625.47,Restaurants,Food
2024-02-09,-17.99,Canva,1638.6,Online Subscriptions,Technology and Services
2024-02-09,-12.99,Spotify P29AECC3DB Sydney AU AUS Card xx1037 Value Date: 07/02/2024,1656.59,Online Subscriptions,Technology and Services
2024-02-09,-14.85,MEDIBANK PHI DEBIT MELBOURNE AUS Card xx1037 Value Date: 07/02/2024,1669.58,Student Fees,Education
2024-02-08,-13.13,Andiamo Kensington St Chippendale AU,1684.43,Restaurants,Food
2024-02-08,-22.0,SUSHI HUB BROADWAY HAYMARKET NS AUS Card xx1037 Value Date: 06/02/2024,1697.56,Restaurants,Food
2024-02-07,-24.8,SIXPROGRESSION PTY LTD ULTIMO NSW AU,1719.56,Restaurants,Food
2024-02-07,-7.5,ANDERSEN'S OF DENMAR COOGEE NS AUS Card xx1037 Value Date: 04/02/2024,1744.36,Food and Beverage,Food
2024-02-07,-4.5,TSG QUAY ST PTY LTD HAYMARKET AUS Card xx1037 Value Date: 04/02/2024,1751.86,Food and Beverage,Food
2024-02-07,-9.95,TSG BROADWAY PTY LTD CHIPPENDALE AUS Card xx1037 Value Date: 03/02/2024,1756.36,Food and Beverage,Food
2024-02-06,-116.48,Direct Debit 119218 Vodafone Aus A3-28e9d3010,1766.31,Mobile Services,Technology and Services
2024-02-06,-24.24,Andiamo Kensington St Chippendale AU,1882.79,Restaurants,Food
2024-02-06,-13.99,CRUNCHYROLL *AUD 415-503-9235 CA USA Card xx1037 AUD 13.99 Value Date: 02/02/2024,1907.03,Online Subscriptions,Technology and Services
2024-02-06,-29.99,ADOBE SYSTEMS PTY LTD SYDNEY AU AUS Card xx1037 Value Date: 01/02/2024,1921.02,Online Subscriptions,Technology and Services
2024-02-06,-5.6,SUSHI HUB BROADWAY HAYMARKET NS AUS Card xx1037 Value Date: 02/02/2024,1951.01,Restaurants,Food
2024-02-06,-16.3,SUSHI HUB BROADWAY HAYMARKET NS AUS Card xx1037 Value Date: 02/02/2024,1956.61,Restaurants,Food
2024-02-06,-9.99,APPLE.COM/BILL SYDNEY NS AUS Card xx1037 Value Date: 03/02/2024,1972.91,Apple,Technology and Services
2024-02-06,-22.5,LIV*ENJOY MIE SYDNEY AU AUS Card xx1037 Value Date: 04/02/2024,1982.9,Restaurants,Food
2024-02-05,-7.1,STARBUCKS COFFEE B01 CHIPPENDALE AU,2005.4,Coffee,Food
2024-02-05,-20.0,LECLOVER PTY LTD SYDNEY NSW AU,2012.5,Restaurants,Food
2024-02-05,-7.1,STARBUCKS COFFEE B00 SYDNEY AU,2032.5,Coffee,Food
2024-02-03,-13.13,Andiamo Kensington St Chippendale AU,2039.6,Restaurants,Food
2024-02-03,-7.1,STARBUCKS COFFEE B00 SYDNEY AU,2052.73,Coffee,Food
2024-02-03,-15.0,SQ *UMMA KITCHEN SYDNE Sydney AU,2059.83,Restaurants,Food
2024-02-03,-17.0,CROCODILE JUNIOR CHIPPENDALE AU AUS Card xx1037 Value Date: 01/02/2024,2074.83,Restaurants,Food
2024-02-03,-6.75,ANDERSEN'S OF DENMAR COOGEE NS AUS Card xx1037 Value Date: 31/01/2024,2091.83,Food and Beverage,Food
2024-02-02,-17.0,SQ *UMMA KITCHEN SYDNE Sydney AU,2098.58,Restaurants,Food
2024-02-02,-7.6,STARBUCKS COFFEE B00 SYDNEY AU,2115.58,Coffee,Food
2024-02-02,-47.12,AUST FEDERAL POLICE SYDNEY NS AUS Card xx1037 Value Date: 31/01/2024,2123.18,Online Subscriptions,Technology and Services
2024-02-02,-7.5,ANDERSEN'S OF DENMAR COOGEE NS AUS Card xx1037 Value Date: 30/01/2024,2170.3,Food and Beverage,Food
2024-02-02,-35.2,SUSHI HUB BROADWAY HAYMARKET NS AUS Card xx1037 Value Date: 31/01/2024,2177.8,Restaurants,Food
2024-02-02,-3.4,Provender Australia SilverwateNSWAU,2213.0,Vending Machine,Food
2024-02-02,-3.4,Provender Australia SilverwateNSWAU,2216.4,Vending Machine,Food
2024-02-01,-1098.0,Direct Debit 505091 IGLU NO205 PTY 66935,2219.8,Rent,Living Expenses
2024-02-01,-19.99,Max Brenner World Squ Sydney AU,3317.8,Food and Beverage,Food
2024-02-01,-4.0,LAT*IgluBroadway Chippindale AU AUS Card xx1037 Value Date: 29/01/2024,3337.79,Rent,Living Expenses
2024-02-01,-4.0,LAT*IgluBroadway Chippindale AU AUS Card xx1037 Value Date: 29/01/2024,3341.79,Rent,Living Expenses
2024-02-01,-4.0,LAT*IgluBroadway Chippindale AU AUS Card xx1037 Value Date: 29/01/2024,3345.79,Rent,Living Expenses
2024-02-01,-4.0,LAT*IgluBroadway Chippindale AU AUS Card xx1037 Value Date: 29/01/2024,3349.79,Rent,Living Expenses
2024-02-01,-7.5,ANDERSEN'S OF DENMAR COOGEE NS AUS Card xx1037 Value Date: 29/01/2024,3353.79,Food and Beverage,Food
2024-02-01,-46.23,LIV*ENJOY MIE SYDNEY AU AUS Card xx1037 Value Date: 30/01/2024,3361.29,Restaurants,Food
2024-02-01,-0.02,Debit Excess Interest,3407.52,Debit,Financial Transactions
2024-01-31,-3.4,Provender Australia SilverwateNSWAU,3407.54,Vending Machine,Food
2024-01-31,-3.4,Provender Australia SilverwateNSWAU,3410.94,Vending Machine,Food
2024-01-31,-7.1,STARBUCKS COFFEE B01 CHIPPENDALE AU,3414.34,Coffee,Food
2024-01-31,3035.0,IZMIRTA RACHMAN REF 2024013100014070,3421.44,Credit,Financial Transactions
2024-01-31,-4.0,LAT*IgluBroadway Chippindale AU AUS Card xx1037 Value Date: 29/01/2024,386.44,Rent,Living Expenses
2024-01-31,-20.81,PALACE CINEMAS CHIPPENDALE NS AUS Card xx1037 Value Date: 28/01/2024,390.44,Entertainment,Activities
2024-01-31,-9.45,TSG CENTRAL PTY LTD HAYMARKET AUS Card xx1037 Value Date: 28/01/2024,411.25,Grocery,Food
2024-01-31,-31.6,SUSHI HUB BROADWAY HAYMARKET NS AUS Card xx1037 Value Date: 27/01/2024,420.7,Restaurants,Food
2024-01-30,-27.5,Cellini's Sydney NS AUS Card xx1037 Value Date: 25/01/2024,452.3,Restaurants,Food
2024-01-30,-34.47,APPLE.COM/BILL SYDNEY NS AUS Card xx1037 Value Date: 25/01/2024,479.8,Apple,Technology and Services
2024-01-30,-47.0,SCRIMBA OSLO DU NOR Card xx1037 AUD 47.00 Value Date: 26/01/2024,514.27,Online Subscriptions,Technology and Services
2024-01-30,-0.46,International Transaction Fee Value Date: 26/01/2024,561.27,Student Fees,Education
2024-01-30,-15.22,WWW.SYMBOLAB.COM REDWOOD CITY CA USA Card xx1037 USD 9.99 Value Date: 26/01/2024,561.73,Online Subscriptions,Technology and Services
2024-01-30,-1.01,International Transaction Fee Value Date: 26/01/2024,576.95,Student Fees,Education
2024-01-30,-33.52,CHATGPT SUBSCRIPTION SAN FRANCISCO CA USA Card xx1037 USD 22.00 Value Date: 27/01/2024,577.96,Online Subscriptions,Technology and Services
2024-01-30,-52.5,LIV*ENJOY MIE SYDNEY AU AUS Card xx1037 Value Date: 26/01/2024,611.48,Restaurants,Food
2024-01-30,-19.9,ZAN Asian Cuisine Sydney NS AUS Card xx1037 Value Date: 28/01/2024,663.98,Restaurants,Food
2024-01-30,-14.11,SYDNEY PIE CAFE HAYMARKET AU AUS Card xx1037 Value Date: 27/01/2024,683.88,Restaurants,Food
2024-01-29,-24.8,SIXPROGRESSION PTY LTD ULTIMO NSW AU,697.99,Restaurants,Food
2024-01-28,-7.9,STARBUCKS COFFEE B00 SYDNEY AU,722.79,Coffee,Food
2024-01-27,-6.09,LS Baia the Italian pt Sydney AU,730.69,Restaurants,Food
2024-01-27,-6.91,Kensington Investment Chippendale AU,736.78,Rent,Living Expenses
2024-01-27,-10.67,Kensington Investment Chippendale AU,743.69,Rent,Living Expenses
2024-01-26,-7.5,ANDERSEN'S OF DENMAR COOGEE NS AUS Card xx1037 Value Date: 23/01/2024,754.36,Food and Beverage,Food
2024-01-26,-0.23,International Transaction Fee Value Date: 24/01/2024,761.86,Student Fees,Education
2024-01-26,-7.62,A MEDIUM CORPORATION 4155085008 CA USA Card xx1037 USD 5.00 Value Date: 25/01/2024,762.09,Online Subscriptions,Technology and Services
2024-01-25,-15.2,MCDONALDS BROADWAY SYDNEY NSWAU,769.71,Restaurants,Food
2024-01-25,-42.63,LIV*ENJOY MIE SYDNEY AU AUS Card xx1037 Value Date: 23/01/2024,784.91,Restaurants,Food
2024-01-25,-3.0,Provender Australia SilverwateNSWAU,827.54,Vending Machine,Food
2024-01-24,-53.89,RIO RECIPE PTY LTD SYDNEY AU,830.54,Restaurants,Food
2024-01-24,-42.95,KINOKUNIYA BOOK STOR SYDNEY AU,884.43,Book,Education
2024-01-24,-16.45,TSG CENTRAL PTY LTD HAYMARKET AUS Card xx1037 Value Date: 21/01/2024,927.38,Grocery,Food
2024-01-23,-3.5,WOOLWORTHS 1905 SYDNEY AU AUS Card xx1037 Value Date: 19/01/2024,943.83,Grocery,Food
2024-01-23,-15.7,TB_Haymarket_3114 Pyrmont AU AUS Card xx1037 Value Date: 21/01/2024,947.33,Restaurants,Food
2024-01-23,-20.9,ZAN Asian Cuisine Sydney NS AUS Card xx1037 Value Date: 21/01/2024,963.03,Restaurants,Food
2024-01-22,-35.0,TIMEZONE HAYMARKET AU Card xx1037,983.93,Entertainment,Activities
2024-01-22,-9.13,Noddles Your Way Sydney AU,1018.93,Restaurants,Food
2024-01-21,-7.9,STARBUCKS COFFEE B00 SYDNEY AU,1028.06,Coffee,Food
2024-01-20,-69.13,HURRICANES GRILL CIRCU SYDNEY AU Card xx1037,1035.96,Restaurants,Food
2024-01-20,-12.9,STARBUCKS COFFEE B01 CHIPPENDALE AU,1105.09,Coffee,Food
2024-01-19,-22.36,SMP*Ed Ae Unique Thai Haymarket02 AU,1117.99,Restaurants,Food
2024-01-19,-16.9,YATAI RICE BOWL PTY LTD HAYMARKET NSW AU,1140.35,Restaurants,Food
2024-01-19,-7.9,STARBUCKS COFFEE B01 CHIPPENDALE AU,1157.25,Coffee,Food
2024-01-18,-15.2,MCDONALDS BROADWAY SYDNEY NSWAU,1165.15,Restaurants,Food
2024-01-18,-1098.0,Direct Debit 505091 IGLU NO205 PTY 66935,1180.35,Rent,Living Expenses
2024-01-18,-35.0,TIMEZONE HAYMARKET AU Card xx1037,2278.35,Entertainment,Activities
2024-01-18,-43.34,PEPPER LUNCH SYDNEY NSWAU,2313.35,Restaurants,Food
2024-01-18,-2.57,LIV*ENJOY MIE SYDNEY AU AUS Card xx1037 Value Date: 16/01/2024,2356.69,Restaurants,Food
2024-01-18,-50.85,LIV*ENJOY MIE SYDNEY AU AUS Card xx1037 Value Date: 16/01/2024,2359.26,Restaurants,Food
2024-01-18,-13.5,TSG BROADWAY PTY LTD CHIPPENDALE AUS Card xx1037 Value Date: 15/01/2024,2410.11,Food and Beverage,Food
2024-01-17,-7.9,STARBUCKS COFFEE B01 CHIPPENDALE AU,2423.61,Coffee,Food
2024-01-16,-121.96,RED EYE RECORDS PTY SYDNEY AU Card xx1037,2431.51,Shopping,Financial Transactions
2024-01-16,-19.98,KINOKUNIYA BOOK STOR SYDNEY AU,2553.47,Book,Education
2024-01-16,-100.93,KINOKUNIYA BOOK STOR SYDNEY AU,2573.45,Book,Education
2024-01-16,-1.35,International Transaction Fee Value Date: 12/01/2024,2674.38,Student Fees,Education
2024-01-16,-45.15,GRAMMARLY COSCYY5T3 8883186146 CA USA Card xx1037 USD 30.00 Value Date: 12/01/2024,2675.73,Online Subscriptions,Technology and Services
2024-01-16,-2.57,LIV*ENJOY MIE SYDNEY AU AUS Card xx1037 Value Date: 13/01/2024,2720.88,Restaurants,Food
2024-01-16,-23.63,LIV*ENJOY MIE SYDNEY AU AUS Card xx1037 Value Date: 13/01/2024,2723.45,Restaurants,Food
2024-01-16,-4.49,APPLE.COM/BILL SYDNEY AU AUS Card xx1037 Value Date: 13/01/2024,2747.08,Apple,Technology and Services
2024-01-16,-15.3,WOOLWORTHS 1905 SYDNEY AU AUS Card xx1037 Value Date: 14/01/2024,2751.57,Grocery,Food
2024-01-16,-54.99,LinkedIn Pre 910759397 lnkd.in/bill AU AUS Card xx1037 Value Date: 14/01/2024,2766.87,Online Subscriptions,Technology and Services
2024-01-15,-13.13,Andiamo Kensington St Chippendale AU,2821.86,Restaurants,Food
2024-01-15,-16.75,ZLR*It's time for Thai Haymarket AU,2834.99,Restaurants,Food
2024-01-14,-41.17,FF Darling Harbour Sydney AU,2851.74,Restaurants,Food
2024-01-13,-21.57,Nene Chicken George Sydney AU,2892.91,Restaurants,Food
2024-01-12,-31.63,Zhangliang spicy hotp Haymarket AU,2914.48,Restaurants,Food
2024-01-12,-7.9,STARBUCKS COFFEE B01 CHIPPENDALE AU,2946.11,Coffee,Food
2024-01-11,-11.06,SYDNEY PIE CAFE HAYMARKET AU,2954.01,Restaurants,Food
2024-01-11,-35.0,TIMEZONE HAYMARKET AU Card xx1037,2965.07,Entertainment,Activities
2024-01-11,-15.0,Overdraw Fee For exceeding available funds on 10 Jan,3000.07,Debit,Financial Transactions
2024-01-11,-7.9,STARBUCKS COFFEE B00 SYDNEY AU,3015.07,Coffee,Food
2024-01-11,-25.5,Fresh & Hot Malatang Chippendale AU,3022.97,Restaurants,Food
2024-01-11,3085.0,IZMIRTA RACHMAN REF 2024011100012993,3048.47,Credit,Financial Transactions
2024-01-11,-4.0,LAT*IgluBroadway Chippindale AU AUS Card xx1037 Value Date: 09/01/2024,-36.53,Rent,Living Expenses
2024-01-11,-4.0,LAT*IgluBroadway Chippindale AU AUS Card xx1037 Value Date: 09/01/2024,-32.53,Rent,Living Expenses
2024-01-11,-4.0,LAT*IgluBroadway Chippindale AU AUS Card xx1037 Value Date: 09/01/2024,-28.53,Rent,Living Expenses
2024-01-11,-4.0,LAT*IgluBroadway Chippindale AU AUS Card xx1037 Value Date: 09/01/2024,-24.53,Rent,Living Expenses
2024-01-11,-4.0,LAT*IgluBroadway Chippindale AU AUS Card xx1037 Value Date: 09/01/2024,-20.53,Rent,Living Expenses
2024-01-11,-4.0,LAT*IgluBroadway Chippindale AU AUS Card xx1037 Value Date: 09/01/2024,-16.53,Rent,Living Expenses
2024-01-11,-17.99,Canva* 04025-19994890 Sydney AU AUS Card xx1037 Value Date: 09/01/2024,-12.53,Online Subscriptions,Technology and Services
2024-01-11,-20.49,APPLE.COM/BILL SYDNEY NS AUS Card xx1037 Value Date: 09/01/2024,5.46,Apple,Technology and Services
2024-01-11,-0.09,International Transaction Fee Value Date: 09/01/2024,25.95,Student Fees,Education
2024-01-11,-2.89,Google Storage Mountain View CA USA Card xx1037 IDR 29859.00 Value Date: 09/01/2024,26.04,Online Subscriptions,Technology and Services
2024-01-10,-6.5,SQ *UMMA KITCHEN SYDNE Sydney AU,28.93,Restaurants,Food
2024-01-10,-17.0,SQ *UMMA KITCHEN SYDNE Sydney AU,35.43,Restaurants,Food
2024-01-10,-9.5,TSG CENTRAL PTY LTD HAYMARKET AUS Card xx1037 Value Date: 05/01/2024,52.43,Grocery,Food
2024-01-10,-10.0,TRANSPORTFORNSW OPAL CHIPPENDALE AUS Card xx1037 Value Date: 09/01/2024,61.93,Transport,Living Expenses
2024-01-09,-116.48,Direct Debit 119218 Vodafone Aus A3-28806f026,71.93,Mobile Services,Technology and Services
2024-01-09,-25.8,ZAN Asian Cuisine Sydney NS AUS Card xx1037 Value Date: 05/01/2024,188.41,Restaurants,Food
2024-01-09,-25.8,ZAN Asian Cuisine Sydney NS AUS Card xx1037 Value Date: 07/01/2024,214.21,Restaurants,Food
2024-01-09,-12.99,Spotify P288D646EE Sydney AU AUS Card xx1037 Value Date: 07/01/2024,240.01,Online Subscriptions,Technology and Services
2024-01-08,-14.1,Hungry Jacks WoolloomoolooAU,253.0,Restaurants,Food
2024-01-08,-23.25,Fresh & Hot Malatang Chippendale AU,267.1,Restaurants,Food
2024-01-07,-10.67,YB CORPORATE PTY LTD Silverwater AU,290.35,Restaurants,Food
2024-01-06,-21.0,SLIMS QUALITY BURGER SYDNEY AU Card xx1037,301.02,Restaurants,Food
2024-01-05,-27.25,Nene Chicken George Sydney AU,322.02,Restaurants,Food
2024-01-05,-9.99,APPLE.COM/BILL SYDNEY AU AUS Card xx1037 Value Date: 03/01/2024,349.27,Apple,Technology and Services
2024-01-04,-1098.0,Direct Debit 505091 IGLU NO205 PTY 66935,359.26,Rent,Living Expenses
2024-01-04,-7.1,STARBUCKS COFFEE B00 SYDNEY AU,1457.26,Coffee,Food
2024-01-04,-21.0,SLIMS QUALITY BURGER SYDNEY AU Card xx1037,1464.36,Restaurants,Food
2024-01-04,-23.38,SMP*Adanos Centrepoint Sydney02 AU,1485.36,Restaurants,Food
2024-01-04,-34.92,MOM RECIPES PTY LTD HAYMARKET AU AUS Card xx1037 Value Date: 02/01/2024,1508.74,Restaurants,Food
2024-01-04,-13.99,CRUNCHYROLL *AUD 415-503-9235 CA USA Card xx1037 AUD 13.99 Value Date: 02/01/2024,1543.66,Online Subscriptions,Technology and Services
2024-01-04,-10.3,SUSHI HUB BROADWAY HAYMARKET NS AUS Card xx1037 Value Date: 02/01/2024,1557.65,Restaurants,Food
2024-01-03,-11.3,STARBUCKS COFFEE B00 SYDNEY AU,1567.95,Coffee,Food
2024-01-03,-35.0,TIMEZONE HAYMARKET AU Card xx1037,1579.25,Entertainment,Activities
2024-01-03,-15.0,SQ *UMMA KITCHEN SYDNE Sydney AU,1614.25,Restaurants,Food
2024-01-03,-10.81,EzyMart 869 George St Sydney NS AUS Card xx1037 Value Date: 29/12/2023,1629.25,Grocery,Food
2024-01-03,-26.71,LIV*ENJOY MIE SYDNEY AU AUS Card xx1037 Value Date: 30/12/2023,1640.06,Restaurants,Food
2024-01-03,-24.14,LIV*ENJOY MIE SYDNEY AU AUS Card xx1037 Value Date: 30/12/2023,1666.77,Restaurants,Food
2024-01-03,-34.47,APPLE.COM/BILL SYDNEY NS AUS Card xx1037 Value Date: 30/12/2023,1690.91,Apple,Technology and Services
2024-01-03,-29.99,ADOBE SYSTEMS PTY LTD SYDNEY AU AUS Card xx1037 Value Date: 01/01/2024,1725.38,Online Subscriptions,Technology and Services
2024-01-01,-26.61,Nene Chicken George Sydney AU,1755.37,Restaurants,Food
2024-01-01,-10.67,YB CORPORATE PTY LTD Silverwater AU,1781.98,Restaurants,Food
2024-01-01,-14.11,SYDNEY PIE CAFE HAYMARKET AU,1792.65,Restaurants,Food
2024-09-12,-7.9,STARBUCKS COFFEE B01 CHIPPENDALE AU,2018.18,Coffee,Food
2024-09-12,-0.1,International Transaction Fee Value Date: 09/09/2024,2026.08,Student Fees,Education
2024-09-12,-2.92,Google One Mountain View CA USA Card xx1037 IDR 29859.00 Value Date: 09/09/2024,2026.18,Online Subscriptions,Technology and Services
2024-09-11,-5.0,TIMEZONE HAYMARKET AU Card xx1037,2029.1,Entertainment,Activities
2024-09-11,-20.0,TIMEZONE HAYMARKET AU Card xx1037,2034.1,Entertainment,Activities
2024-09-11,-16.4,PMC GOLDEN TOWER PTY L HAYMARKET AU,2054.1,Restaurants,Food
2024-09-11,-20.0,TIMEZONE HAYMARKET AU Card xx1037,2070.5,Entertainment,Activities
2024-09-11,-3.4,Provender Australia SilverwateNSWAU,2090.5,Vending Machine,Food
2024-09-11,-3.4,Provender Australia SilverwateNSWAU,2093.9,Vending Machine,Food
2024-09-10,-26.6,GRILLD PTY LTD - BROAD BROADWAY AU Card xx1037,2097.3,Restaurants,Food
2024-09-10,-10.29,QONUS* HIW SO CHATSWOOD NS AUS Card xx1037 Value Date: 07/09/2024,2123.9,Restaurants,Food
2024-09-10,-19.45,QONUS* HIW SO CHATSWOOD NS AUS Card xx1037 Value Date: 07/09/2024,2134.19,Restaurants,Food
2024-09-10,-13.99,Spotify P2FB84FF4B Sydney AU AUS Card xx1037 Value Date: 08/09/2024,2153.64,Online Subscriptions,Technology and Services
2024-09-09,-16.4,PMC GOLDEN TOWER PTY L HAYMARKET AU,2167.63,Restaurants,Food
2024-09-09,-20.0,TIMEZONE HAYMARKET AU Card xx1037,2184.03,Entertainment,Activities
2024-09-09,-24.28,Little Indo Town Chippendale AU,2204.03,Restaurants,Food
2024-09-08,-7.21,Sharetea RSQ Chippendale AU,2228.31,Food and Beverage,Food
2024-09-08,-20.0,TIMEZONE HAYMARKET AU Card xx1037,2235.52,Entertainment,Activities
2024-09-08,-27.91,Zhangliang spicy hotp Haymarket AU,2255.52,Restaurants,Food
2024-09-07,-20.0,TIMEZONE HAYMARKET AU Card xx1037,2283.43,Entertainment,Activities
2024-09-07,-23.63,ENJOY MIE SYDNEY 02 AUS Card xx1037 Value Date: 05/09/2024,2303.43,Restaurants,Food
2024-09-06,-15.4,MCDONALDS BROADWAY SYDNEY NSWAU,2327.06,Restaurants,Food
2024-09-06,-20.0,TIMEZONE HAYMARKET AU Card xx1037,2342.46,Entertainment,Activities
2024-09-06,-20.1,HUNGER KEBAB PTY LTD ULTIMO NS AUS Card xx1037 Value Date: 03/09/2024,2362.46,Restaurants,Food
2024-09-06,-9.99,APPLE.COM/BILL SYDNEY AU AUS Card xx1037 Value Date: 03/09/2024,2382.56,Apple,Technology and Services
2024-09-06,-19.45,QONUS* HIW SO CHATSWOOD NS AUS Card xx1037 Value Date: 04/09/2024,2392.55,Restaurants,Food
2024-09-06,-33.48,APPLE.COM/BILL SYDNEY AU AUS Card xx1037 Value Date: 04/09/2024,2412.0,Apple,Technology and Services
2024-09-05,-20.0,TIMEZONE HAYMARKET AU Card xx1037,2445.48,Entertainment,Activities
2024-09-05,-123.68,Direct Debit 119218 Vodafone Aus A3-2bb1ef01a,2465.48,Mobile Services,Technology and Services
2024-09-05,-7.21,Sharetea RSQ Chippendale AU,2589.16,Food and Beverage,Food
2024-09-05,-16.3,SUSHI HUB BROADWAY HAYMARKET NS AUS Card xx1037 Value Date: 02/09/2024,2596.37,Restaurants,Food
2024-09-04,-20.0,TIMEZONE HAYMARKET AU Card xx1037,2612.67,Entertainment,Activities
2024-09-04,-20.0,TIMEZONE HAYMARKET AU Card xx1037,2632.67,Entertainment,Activities
2024-09-04,-7.9,STARBUCKS COFFEE B00 SYDNEY AU,2652.67,Coffee,Food
2024-09-04,0.01,Refund Purchase UBER* TRIP,2660.57,Credit,Financial Transactions
2024-09-04,-18.69,UBER* TRIP,2660.56,Transport,Living Expenses
2024-09-04,-13.99,CRUNCHYROLL *AUD 415-503-9235 CA USA Card xx1037 AUD 13.99 Value Date: 02/09/2024,2679.25,Online Subscriptions,Technology and Services
2024-09-04,-21.98,ENJOY MIE SYDNEY 02 AUS Card xx1037 Value Date: 02/09/2024,2693.24,Restaurants,Food
2024-09-03,-39.31,PEPPER LUNCH SYDNEY NSWAU,2715.22,Restaurants,Food
2024-09-03,-19.18,SWEET TOWN ON GEORGE HAYMARKET 02 AUS Card xx1037 Value Date: 30/08/2024,2754.53,Restaurants,Food
2024-09-03,-20.1,HUNGER KEBAB PTY LTD ULTIMO NS AUS Card xx1037 Value Date: 31/08/2024,2773.71,Restaurants,Food
2024-09-03,-29.99,ADOBE ADOBE.LY/ENAU AU AUS Card xx1037 Value Date: 01/09/2024,2793.81,Online Subscriptions,Technology and Services
2024-09-02,-7.1,STARBUCKS COFFEE B00 SYDNEY AU,2823.8,Coffee,Food
2024-09-02,-20.0,TIMEZONE HAYMARKET AU Card xx1037,2830.9,Entertainment,Activities
2024-09-01,-15.4,MCDONALDS BROADWAY SYDNEY NSWAU,2850.9,Restaurants,Food
2024-09-01,-7.6,STARBUCKS COFFEE B00 SYDNEY AU,2866.3,Coffee,Food
2024-09-01,-20.0,TIMEZONE HAYMARKET AU Card xx1037,2873.9,Entertainment,Activities
2024-09-01,-26.03,Zhangliang spicy hotp Haymarket AU,2893.9,Restaurants,Food
2024-08-31,-20.0,TIMEZONE HAYMARKET AU Card xx1037,2919.93,Entertainment,Activities
2024-08-31,-5.95,TSG BROADWAY CHIPPENDALE NSW AU,2939.93,Food and Beverage,Food
2024-08-31,-25.3,Little Indo Town Chippendale AU,2945.88,Restaurants,Food
2024-08-30,-25.3,Little Indo Town Chippendale AU,2971.18,Restaurants,Food
2024-08-29,-1130.0,Direct Debit 505091 IGLU NO205 PTY 66935,2996.48,Rent,Living Expenses
2024-08-29,-15.8,MCDONALDS DARLING QTR SYDNEY NSWAU,4126.48,Restaurants,Food
2024-08-29,-22.85,SQ *ENJOY MIE Ultimo AU,4142.28,Restaurants,Food
2024-08-29,-14.9,UNI OF SYDNEY UNION UNI OF SYDNEY NS AUS Card xx1037 Value Date: 27/08/2024,4165.13,Student Fees,Education
2024-08-28,-14.55,Hungry Jacks WoolloomoolooAU,4180.03,Restaurants,Food
2024-08-28,-7.21,Sharetea RSQ Chippendale AU,4194.58,Food and Beverage,Food
2024-08-28,-20.0,TIMEZONE HAYMARKET AU Card xx1037,4201.79,Entertainment,Activities
2024-08-28,-31.17,Zhangliang spicy hotp Haymarket AU,4221.79,Restaurants,Food
2024-08-28,3185.0,IZMIRTA RACHMAN REF 2024082800012149,4252.96,Credit,Financial Transactions
2024-08-28,-0.52,International Transaction Fee Value Date: 26/08/2024,1067.96,Student Fees,Education
2024-08-28,-14.92,WWW.SYMBOLAB.COM REDWOOD CITY CA USA Card xx1037 USD 9.99 Value Date: 26/08/2024,1068.48,Online Subscriptions,Technology and Services
2024-08-28,-1.15,International Transaction Fee Value Date: 26/08/2024,1083.4,Student Fees,Education
2024-08-28,-32.86,OPENAI *CHATGPT SUBSCR SAN FRANCISCO CA USA Card xx1037 USD 22.00 Value Date: 26/08/2024,1084.55,Online Subscriptions,Technology and Services
2024-08-28,-23.63,ENJOY MIE SYDNEY 02 AUS Card xx1037 Value Date: 26/08/2024,1117.41,Restaurants,Food
2024-08-28,-10.0,TRANSPORTFORNSW OPAL CHIPPENDALE AUS Card xx1037 Value Date: 27/08/2024,1141.04,Transport,Living Expenses
2024-08-27,-20.0,TIMEZONE HAYMARKET AU Card xx1037,1151.04,Entertainment,Activities
2024-08-27,-16.4,PMC GOLDEN TOWER PTY L HAYMARKET AU,1171.04,Restaurants,Food
2024-08-27,-15.28,SQ *YOUR DESSERT STATI Gladesville AU,1187.44,Food and Beverage,Food
2024-08-27,-0.26,International Transaction Fee Value Date: 24/08/2024,1202.72,Student Fees,Education
2024-08-27,-7.47,A MEDIUM CORPORATION 4155085008 CA USA Card xx1037 USD 5.00 Value Date: 25/08/2024,1202.98,Online Subscriptions,Technology and Services
2024-08-27,-6.45,WOOLWORTHS 1905 SYDNEY AU AUS Card xx1037 Value Date: 25/08/2024,1210.45,Grocery,Food
2024-08-27,-47.0,SCRIMBA OSLO DU NOR Card xx1037 AUD 47.00 Value Date: 26/08/2024,1216.9,Online Subscriptions,Technology and Services
2024-08-26,-21.52,Spago Darling Square Haymarket AU,1263.9,Restaurants,Food
2024-08-26,-20.0,TIMEZONE HAYMARKET AU Card xx1037,1285.42,Entertainment,Activities
2024-08-25,-13.8,MCDONALDS DARLING QTR SYDNEY NSWAU,1305.42,Restaurants,Food
2024-08-25,-20.0,TIMEZONE HAYMARKET AU Card xx1037,1319.22,Entertainment,Activities
2024-08-25,-20.0,TIMEZONE HAYMARKET AU Card xx1037,1339.22,Entertainment,Activities
2024-08-25,-13.99,PLINE PH CENTRAL PAR CHIPPENDALE NSWAU,1359.22,Pharmacy,Personal Care
2024-08-25,-25.3,Little Indo Town Chippendale AU,1373.21,Restaurants,Food
2024-08-24,-3.0,Provender Australia SilverwateNSWAU,1398.51,Vending Machine,Food
2024-08-24,-3.4,Provender Australia SilverwateNSWAU,1401.51,Vending Machine,Food
2024-08-24,-7.09,SQ *MAPO GELATO PTY LT Bondi Beach AU,1404.91,Food and Beverage,Food
2024-08-24,-21.48,APPLE.COM/BILL SYDNEY NS AUS Card xx1037 Value Date: 22/08/2024,1412.0,Apple,Technology and Services
2024-08-24,-5.55,WOOLWORTHS 1905 SYDNEY AU AUS Card xx1037 Value Date: 22/08/2024,1433.48,Grocery,Food
2024-08-23,-20.0,TIMEZONE HAYMARKET AU Card xx1037,1439.03,Entertainment,Activities
2024-08-23,-31.17,Zhangliang spicy hotp Haymarket AU,1459.03,Restaurants,Food
2024-08-22,-20.0,TIMEZONE HAYMARKET AU Card xx1037,1490.2,Entertainment,Activities
2024-08-22,-22.85,SQ *ENJOY MIE Ultimo AU,1510.2,Restaurants,Food
2024-08-21,-28.1,REDFERN FISH AND CHIPS REDFERN AU Card xx1037,1533.05,Restaurants,Food
2024-08-21,-21.98,ENJOY MIE SYDNEY 02 AUS Card xx1037 Value Date: 19/08/2024,1561.15,Restaurants,Food
2024-08-20,-20.0,TIMEZONE HAYMARKET AU Card xx1037,1583.13,Entertainment,Activities
2024-08-20,-20.3,SQ *IT'S TIME FOR THAI Haymarket AU,1603.13,Restaurants,Food
2024-08-20,-7.1,STARBUCKS COFFEE B01 CHIPPENDALE AU,1623.43,Coffee,Food
2024-08-20,-17.0,CROCODILE JUNIOR CHIPPENDALE AU AUS Card xx1037 Value Date: 16/08/2024,1630.53,Restaurants,Food
2024-08-20,-39.95,TARONGA ZOO MOSMAN NS AUS Card xx1037 Value Date: 17/08/2024,1647.53,Events,Activities
2024-08-20,-5.2,TARONGA ZOO MOSMAN NS AUS Card xx1037 Value Date: 17/08/2024,1687.48,Events,Activities
2024-08-20,-31.0,ALLIANCE OPCO PTY LT MOSMAN NS AUS Card xx1037 Value Date: 17/08/2024,1692.68,Student Fees,Education
2024-08-20,-10.0,TRANSPORTFORNSW OPAL CHIPPENDALE AUS Card xx1037 Value Date: 17/08/2024,1723.68,Transport,Living Expenses
2024-08-19,-7.1,Sharetea RSQ Chippendale AU,1733.68,Food and Beverage,Food
2024-08-19,-26.19,Spago Darling Square Haymarket AU,1740.78,Restaurants,Food
2024-08-19,-4.2,Provender Australia SilverwateNSWAU,1766.97,Vending Machine,Food
2024-08-18,-25.3,Little Indo Town Chippendale AU,1771.17,Restaurants,Food
2024-08-17,-19.17,ZLR*77 Restaurant and B Sydney AU,1796.47,Restaurants,Food
2024-08-17,0.01,Refund Purchase UBER* TRIP,1815.64,Credit,Financial Transactions
2024-08-17,-14.31,UBER* TRIP,1815.63,Transport,Living Expenses
2024-08-17,-14.17,UBER* TRIP,1829.94,Transport,Living Expenses
2024-08-17,-4.2,PROVENDER HOLDINGS AUS Waterloo AU AUS Card xx1037 Value Date: 14/08/2024,1844.11,Vending Machine,Food
2024-08-17,-4.2,PROVENDER HOLDINGS AUS Waterloo AU AUS Card xx1037 Value Date: 14/08/2024,1848.31,Vending Machine,Food
2024-08-17,-23.63,ENJOY MIE SYDNEY 02 AUS Card xx1037 Value Date: 15/08/2024,1852.51,Restaurants,Food
2024-08-16,-19.3,RACHA THANI PTY LTD HAYMARKET NSWAU,1876.14,Restaurants,Food
2024-08-16,-20.0,TIMEZONE HAYMARKET AU Card xx1037,1895.44,Entertainment,Activities
2024-08-16,-7.11,Little Indo Town Chippendale AU,1915.44,Restaurants,Food
2024-08-16,-54.99,LinkedIn Pre P13642246 lnkd.in/bill AU AUS Card xx1037 Value Date: 14/08/2024,1922.55,Online Subscriptions,Technology and Services
2024-08-16,-19.45,QONUS* HIW SO CHATSWOOD NS AUS Card xx1037 Value Date: 14/08/2024,1977.54,Restaurants,Food
2024-08-15,-1130.0,Direct Debit 505091 IGLU NO205 PTY 66935,1996.99,Rent,Living Expenses
2024-08-15,-20.0,TIMEZONE HAYMARKET AU Card xx1037,3126.99,Entertainment,Activities
2024-08-15,-4.49,APPLE.COM/BILL SYDNEY NS AUS Card xx1037 Value Date: 13/08/2024,3146.99,Apple,Technology and Services
2024-08-15,-21.98,ENJOY MIE SYDNEY 02 AUS Card xx1037 Value Date: 13/08/2024,3151.48,Restaurants,Food
2024-08-14,-20.0,TIMEZONE HAYMARKET AU Card xx1037,3173.46,Entertainment,Activities
2024-08-14,2185.0,IZMIRTA RACHMAN REF 2024081400012088,3193.46,Credit,Financial Transactions
2024-08-14,-7.9,STARBUCKS COFFEE B01 CHIPPENDALE AU,1008.46,Coffee,Food
2024-08-14,-1.6,International Transaction Fee Value Date: 12/08/2024,1016.36,Student Fees,Education
2024-08-14,-45.7,GRAMMARLY COB7F3MEC 8883186146 CA USA Card xx1037 USD 30.00 Value Date: 12/08/2024,1017.96,Online Subscriptions,Technology and Services
2024-08-14,-121.2,MEDIBANK PHI DEBIT MELBOURNE AUS Card xx1037 Value Date: 12/08/2024,1063.66,Student Fees,Education
2024-08-13,-20.0,TIMEZONE HAYMARKET AU Card xx1037,1184.86,Entertainment,Activities
2024-08-13,-10.9,STARBUCKS COFFEE B01 CHIPPENDALE AU,1204.86,Coffee,Food
2024-08-13,-0.1,International Transaction Fee Value Date: 09/08/2024,1215.76,Student Fees,Education
2024-08-13,-2.89,Google One Mountain View CA USA Card xx1037 IDR 29859.00 Value Date: 09/08/2024,1215.86,Online Subscriptions,Technology and Services
2024-08-12,-29.33,HOLY BASIL DARLING SQUARE HAYMARK NSW AU Card xx1037,1218.75,Restaurants,Food
2024-08-12,-20.0,IGLU NO. 205 PTY LTD CHIPPENDALE NSW AU,1248.08,Rent,Living Expenses
2024-08-12,-26.82,Little Indo Town Chippendale AU,1268.08,Restaurants,Food
2024-08-11,-6.8,YOMIE'S RICE X YOGURT Haymarket AU,1294.9,Food and Beverage,Food
2024-08-11,-35.0,TIMEZONE HAYMARKET AU Card xx1037,1301.7,Entertainment,Activities
2024-08-11,-38.62,KENSINGTON INVESTMENT Chippendale AU,1336.7,Rent,Living Expenses
2024-08-10,-21.28,SQ *BOWLS & BURGER SUR Surry Hills AU,1375.32,Restaurants,Food
2024-08-10,-24.0,WOOLWORTHS 1905 SYDNEY AU AUS Card xx1037 Value Date: 08/08/2024,1396.6,Grocery,Food
2024-08-10,-13.99,Spotify P2E5BC3C3C Sydney AU AUS Card xx1037 Value Date: 08/08/2024,1420.6,Online Subscriptions,Technology and Services
2024-08-09,-7.9,STARBUCKS COFFEE B00 SYDNEY AU,1434.59,Coffee,Food
2024-08-09,-35.0,TIMEZONE HAYMARKET AU Card xx1037,1442.49,Entertainment,Activities
2024-08-09,-21.83,SQ *ENJOY MIE Ultimo AU,1477.49,Restaurants,Food
2024-08-09,-17.99,Canva* 04238-22466756,1499.32,Online Subscriptions,Technology and Services
2024-08-09,-10.29,QONUS* HIW SO CHATSWOOD NS AUS Card xx1037 Value Date: 07/08/2024,1517.31,Restaurants,Food
2024-08-09,-19.45,QONUS* HIW SO CHATSWOOD NS AUS Card xx1037 Value Date: 07/08/2024,1527.6,Restaurants,Food
2024-08-08,-15.0,TIMEZONE HAYMARKET AU Card xx1037,1547.05,Entertainment,Activities
2024-08-08,-123.68,Direct Debit 119218 Vodafone Aus A3-2b59cd04,1562.05,Mobile Services,Technology and Services
2024-08-08,-34.28,ZLR*77 Restaurant and B Sydney AU,1685.73,Restaurants,Food
2024-08-08,-15.0,TIMEZONE HAYMARKET AU Card xx1037,1720.01,Entertainment,Activities
2024-08-08,-35.0,TIMEZONE HAYMARKET AU Card xx1037,1735.01,Entertainment,Activities
2024-08-08,-26.82,Little Indo Town Chippendale AU,1770.01,Restaurants,Food
2024-08-08,-4.0,LAT*IgluBroadway Chippindale AU AUS Card xx1037 Value Date: 05/08/2024,1796.83,Rent,Living Expenses
2024-08-08,-4.0,LAT*IgluBroadway Chippindale AU AUS Card xx1037 Value Date: 05/08/2024,1800.83,Rent,Living Expenses
2024-08-08,-4.0,LAT*IgluBroadway Chippindale AU AUS Card xx1037 Value Date: 05/08/2024,1804.83,Rent,Living Expenses
2024-08-08,-4.0,LAT*IgluBroadway Chippindale AU AUS Card xx1037 Value Date: 05/08/2024,1808.83,Rent,Living Expenses
2024-08-07,-35.0,TIMEZONE HAYMARKET AU Card xx1037,1812.83,Entertainment,Activities
2024-08-07,-7.9,STARBUCKS COFFEE B00 SYDNEY AU,1847.83,Coffee,Food
2024-08-07,-35.0,TIMEZONE HAYMARKET AU Card xx1037,1855.73,Entertainment,Activities
2024-08-06,-35.0,TIMEZONE HAYMARKET AU Card xx1037,1890.73,Entertainment,Activities
2024-08-06,-25.81,Little Indo Town Chippendale AU,1925.73,Restaurants,Food
2024-08-06,-7.9,STARBUCKS COFFEE B00 SYDNEY AU,1951.54,Coffee,Food
2024-08-06,-13.99,CRUNCHYROLL *AUD 415-503-9235 CA USA Card xx1037 AUD 13.99 Value Date: 02/08/2024,1959.44,Online Subscriptions,Technology and Services
2024-08-06,-21.98,ENJOY MIE SYDNEY 02 AUS Card xx1037 Value Date: 02/08/2024,1973.43,Restaurants,Food
2024-08-06,-15.4,WOOLWORTHS 1905 SYDNEY AU AUS Card xx1037 Value Date: 04/08/2024,1995.41,Grocery,Food
2024-08-06,-9.99,APPLE.COM/BILL SYDNEY AU AUS Card xx1037 Value Date: 03/08/2024,2010.81,Apple,Technology and Services
2024-08-05,-21.83,SQ *ENJOY MIE Ultimo AU,2020.8,Restaurants,Food
2024-08-05,-15.0,IGLU NO. 205 PTY LTD CHIPPENDALE NSW AU Card xx1037,2042.63,Rent,Living Expenses
2024-08-04,-23.65,Spago Darling Square Haymarket AU,2057.63,Restaurants,Food
2024-08-04,-35.0,TIMEZONE HAYMARKET AU Card xx1037,2081.28,Entertainment,Activities
2024-08-04,-25.81,Little Indo Town Chippendale AU,2116.28,Restaurants,Food
2024-08-03,-25.81,Little Indo Town Chippendale AU,2142.09,Restaurants,Food
2024-08-03,-29.99,ADOBE ADOBE.LY/ENAU AU AUS Card xx1037 Value Date: 01/08/2024,2167.9,Online Subscriptions,Technology and Services
2024-08-02,-35.0,TIMEZONE HAYMARKET AU Card xx1037,2197.89,Entertainment,Activities
2024-08-02,-20.49,APPLE.COM/BILL SYDNEY AU AUS Card xx1037 Value Date: 30/07/2024,2232.89,Apple,Technology and Services
2024-08-01,-1130.0,Direct Debit 505091 IGLU NO205 PTY 66935,2253.38,Rent,Living Expenses
2024-08-01,-11.9,STARBUCKS COFFEE B00 SYDNEY AU,3383.38,Coffee,Food
2024-08-01,-35.0,TIMEZONE HAYMARKET AU Card xx1037,3395.28,Entertainment,Activities
2024-08-01,-24.79,Little Indo Town Chippendale AU,3430.28,Restaurants,Food
2024-08-01,-4.0,LAT*IgluBroadway Chippindale AU AUS Card xx1037 Value Date: 29/07/2024,3455.07,Rent,Living Expenses
2024-08-01,-21.81,PANCAKES ON THE ROCKS HAYMARKET NS AUS Card xx1037 Value Date: 30/07/2024,3459.07,Restaurants,Food
2024-07-31,-23.27,Little Indo Town Chippendale AU,3480.88,Restaurants,Food
2024-07-31,-7.1,STARBUCKS COFFEE B01 CHIPPENDALE AU,3504.15,Coffee,Food
2024-07-31,-4.0,LAT*IgluBroadway Chippindale AU AUS Card xx1037 Value Date: 29/07/2024,3511.25,Rent,Living Expenses
2024-07-31,-4.0,LAT*IgluBroadway Chippindale AU AUS Card xx1037 Value Date: 29/07/2024,3515.25,Rent,Living Expenses
2024-07-31,-4.0,LAT*IgluBroadway Chippindale AU AUS Card xx1037 Value Date: 29/07/2024,3519.25,Rent,Living Expenses
2024-07-31,-4.0,LAT*IgluBroadway Chippindale AU AUS Card xx1037 Value Date: 29/07/2024,3523.25,Rent,Living Expenses
2024-07-31,-4.0,LAT*IgluBroadway Chippindale AU AUS Card xx1037 Value Date: 29/07/2024,3527.25,Rent,Living Expenses
2024-07-30,-35.0,TIMEZONE HAYMARKET AU Card xx1037,3531.25,Entertainment,Activities
2024-07-30,-20.3,SQ *IT'S TIME FOR THAI Haymarket AU,3566.25,Restaurants,Food
2024-07-30,3185.0,IZMIRTA RACHMAN REF 2024073000010962,3586.55,Credit,Financial Transactions
2024-07-30,-0.54,International Transaction Fee Value Date: 26/07/2024,401.55,Student Fees,Education
2024-07-30,-15.34,WWW.SYMBOLAB.COM REDWOOD CITY CA USA Card xx1037 USD 9.99 Value Date: 26/07/2024,402.09,Online Subscriptions,Technology and Services
2024-07-30,-12.99,APPLE.COM/BILL SYDNEY AU AUS Card xx1037 Value Date: 25/07/2024,417.43,Apple,Technology and Services
2024-07-30,-1.18,International Transaction Fee Value Date: 26/07/2024,430.42,Student Fees,Education
2024-07-30,-33.78,OPENAI *CHATGPT SUBSCR SAN FRANCISCO CA USA Card xx1037 USD 22.00 Value Date: 26/07/2024,431.6,Online Subscriptions,Technology and Services
2024-07-30,-10.0,TRANSPORTFORNSW OPAL CHIPPENDALE AUS Card xx1037 Value Date: 28/07/2024,465.38,Transport,Living Expenses
2024-07-29,-35.68,PEPPER LUNCH SYDNEY NSWAU,475.38,Restaurants,Food
2024-07-29,-3.0,SIXPROGRESSION PTY LTD ULTIMO NSW AU,511.06,Restaurants,Food
2024-07-29,-21.8,SIXPROGRESSION PTY LTD ULTIMO NSW AU,514.06,Restaurants,Food
2024-07-28,-20.3,SQ *IT'S TIME FOR THAI Haymarket AU,535.86,Restaurants,Food
2024-07-28,-3.04,SQ *GEPREK IN SYDNEY Burwood AU,556.16,Restaurants,Food
2024-07-28,-18.25,SQ *GEPREK IN SYDNEY Burwood AU,559.2,Restaurants,Food
2024-07-27,-60.0,TIMEZONE HAYMARKET AU Card xx1037,577.45,Entertainment,Activities
2024-07-27,-32.8,Nandos_AU_Pinpads Broadway AU,637.45,Restaurants,Food
2024-07-27,-20.1,HUNGER KEBAB PTY LTD ULTIMO NS AUS Card xx1037 Value Date: 24/07/2024,670.25,Restaurants,Food
2024-07-27,-47.0,SCRIMBA OSLO DU NOR Card xx1037 AUD 47.00 Value Date: 26/07/2024,690.35,Online Subscriptions,Technology and Services
2024-07-26,-35.0,TIMEZONE HAYMARKET AU Card xx1037,737.35,Entertainment,Activities
2024-07-26,-21.83,SQ *ENJOY MIE Ultimo AU,772.35,Restaurants,Food
2024-07-26,-0.26,International Transaction Fee Value Date: 24/07/2024,794.18,Student Fees,Education
2024-07-26,-7.57,A MEDIUM CORPORATION 4155085008 CA USA Card xx1037 USD 5.00 Value Date: 24/07/2024,794.44,Online Subscriptions,Technology and Services
2024-07-25,-8.02,SYDNEY PIE CAFE HAYMARKET AU,802.01,Restaurants,Food
2024-07-25,-7.9,STARBUCKS COFFEE B00 SYDNEY AU,810.03,Coffee,Food
2024-07-25,-35.0,TIMEZONE HAYMARKET AU Card xx1037,817.93,Entertainment,Activities
2024-07-25,-4.07,LS Slaps Chippendale AU,852.93,Restaurants,Food
2024-07-25,-18.3,LS Slaps Chippendale AU,857.0,Restaurants,Food
2024-07-25,-21.48,APPLE.COM/BILL SYDNEY AU AUS Card xx1037 Value Date: 22/07/2024,875.3,Apple,Technology and Services
2024-07-25,-21.98,ENJOY MIE SYDNEY 02 AUS Card xx1037 Value Date: 23/07/2024,896.78,Restaurants,Food
2024-07-25,-10.0,TRANSPORTFORNSW OPAL CHIPPENDALE AUS Card xx1037 Value Date: 24/07/2024,918.76,Transport,Living Expenses
2024-07-24,-7.71,CHATIME BURWOOD WESTF Burwood AU,928.76,Food and Beverage,Food
2024-07-24,-17.75,SLAR GROUP PTY LTD BURWOOD AU Card xx1037,936.47,Restaurants,Food
2024-07-24,-3.99,BURWOOD PHARMACY NSW P BURWOOD AU Card xx1037,954.22,Pharmacy,Personal Care
2024-07-24,-4.2,PROVENDER HOLDINGS AUS Waterloo AU AUS Card xx1037 Value Date: 21/07/2024,958.21,Vending Machine,Food
2024-07-24,-4.2,Provender Australia SilverwateNSWAU,962.41,Vending Machine,Food
2024-07-24,-3.0,Provender Australia SilverwateNSWAU,966.61,Vending Machine,Food
2024-07-23,-16.75,ZLR*It's time for Thai Haymarket AU,969.61,Restaurants,Food
2024-07-23,-3.4,PROVENDER HOLDINGS AUS Waterloo AU AUS Card xx1037 Value Date: 20/07/2024,986.36,Vending Machine,Food
2024-07-23,-23.37,DiDiMobility Sydney AU AUS Card xx1037 Value Date: 21/07/2024,989.76,Transport,Living Expenses
2024-07-23,-24.36,SUNFLOWER TAIWANESE ULTIMO NS AUS Card xx1037 Value Date: 20/07/2024,1013.13,Restaurants,Food
2024-07-22,-35.0,TIMEZONE HAYMARKET AU Card xx1037,1037.49,Entertainment,Activities
2024-07-22,-30.74,PEPPER LUNCH SYDNEY NSWAU,1072.49,Restaurants,Food
2024-07-22,-37.61,KENSINGTON INVESTMENT Chippendale AU,1103.23,Rent,Living Expenses
2024-07-21,-4.2,Provender Australia SilverwateNSWAU,1140.84,Vending Machine,Food
2024-07-21,-25.0,WESTSHELL PTY LTD SYDNEY NSW AU,1145.04,Events,Activities
2024-07-21,-12.14,WESTSHELL PTY LTD SYDNEY NSW AU,1170.04,Events,Activities
2024-07-21,-24.29,SURFISH BONDI BEACH NSWAU,1182.18,Restaurants,Food
2024-07-20,-7.9,STARBUCKS COFFEE B00 SYDNEY AU,1206.47,Coffee,Food
2024-07-20,-35.0,TIMEZONE HAYMARKET AU Card xx1037,1214.37,Entertainment,Activities
2024-07-20,-23.24,SWEET TOWN ON GEORGE S HAYMARKET 02 AUS Card xx1037 Value Date: 17/07/2024,1249.37,Restaurants,Food
2024-07-19,-4.2,Provender Australia SilverwateNSWAU Value Date: 20/07/2024,1272.61,Vending Machine,Food
2024-07-19,-3.4,Provender Australia SilverwateNSWAU Value Date: 20/07/2024,1276.81,Vending Machine,Food
2024-07-19,-29.0,LANGUAGE ACADEMY,1280.21,Online Subscriptions,Technology and Services
2024-07-19,-7.9,STARBUCKS COFFEE B01 CHIPPENDALE AU,1309.21,Coffee,Food
2024-07-19,-23.46,SQ *ENJOY MIE Ultimo AU,1317.11,Restaurants,Food
2024-07-18,-1130.0,Direct Debit 505091 IGLU NO205 PTY 66935,1340.57,Rent,Living Expenses
2024-07-18,-12.08,SYDNEY PIE CAFE HAYMARKET AU,2470.57,Restaurants,Food
2024-07-18,-35.0,TIMEZONE HAYMARKET AU Card xx1037,2482.65,Entertainment,Activities
2024-07-18,-21.83,SQ *ENJOY MIE Ultimo AU,2517.65,Restaurants,Food
2024-07-18,-4.0,LAT*IgluBroadway Chippindale AU AUS Card xx1037 Value Date: 16/07/2024,2539.48,Rent,Living Expenses
2024-07-18,-4.0,LAT*IgluBroadway Chippindale AU AUS Card xx1037 Value Date: 15/07/2024,2543.48,Rent,Living Expenses
2024-07-18,-4.0,LAT*IgluBroadway Chippindale AU AUS Card xx1037 Value Date: 16/07/2024,2547.48,Rent,Living Expenses
2024-07-18,-4.0,LAT*IgluBroadway Chippindale AU AUS Card xx1037 Value Date: 15/07/2024,2551.48,Rent,Living Expenses
2024-07-18,-4.0,LAT*IgluBroadway Chippindale AU AUS Card xx1037 Value Date: 15/07/2024,2555.48,Rent,Living Expenses
2024-07-17,-7.9,STARBUCKS COFFEE B00 SYDNEY AU,2559.48,Coffee,Food
2024-07-17,-27.88,Roll'd Westfield Sydney AU,2567.38,Restaurants,Food
2024-07-17,-32.8,NANDOS BROADWAY NSW Broadway AU AUS Card xx1037 Value Date: 15/07/2024,2595.26,Restaurants,Food
2024-07-17,-3.0,Provender Australia SilverwateNSWAU,2628.06,Vending Machine,Food
2024-07-17,-3.4,Provender Australia SilverwateNSWAU,2631.06,Vending Machine,Food
2024-07-17,-3.4,Provender Australia SilverwateNSWAU,2634.46,Vending Machine,Food
2024-07-17,-3.2,Provender Australia SilverwateNSWAU,2637.86,Vending Machine,Food
2024-07-16,-35.0,TIMEZONE HAYMARKET AU Card xx1037,2641.06,Entertainment,Activities
2024-07-16,-21.83,SQ *ENJOY MIE Ultimo AU,2676.06,Restaurants,Food
2024-07-16,-15.0,HAYMARKET KEBAB HAYMARKET AU AUS Card xx1037 Value Date: 12/07/2024,2697.89,Restaurants,Food
2024-07-16,-1.56,International Transaction Fee Value Date: 12/07/2024,2712.89,Student Fees,Education
2024-07-16,-44.54,GRAMMARLY COBDOVGLS 8883186146 CA USA Card xx1037 USD 30.00 Value Date: 12/07/2024,2714.45,Online Subscriptions,Technology and Services
2024-07-16,-3.4,PROVENDER HOLDINGS AUS Waterloo AU AUS Card xx1037 Value Date: 12/07/2024,2758.99,Vending Machine,Food
2024-07-16,-3.4,PROVENDER HOLDINGS AUS Waterloo AU AUS Card xx1037 Value Date: 12/07/2024,2762.39,Vending Machine,Food
2024-07-16,-23.24,SWEET TOWN ON GEORGE S HAYMARKET 02 AUS Card xx1037 Value Date: 12/07/2024,2765.79,Restaurants,Food
2024-07-16,-12.3,SUSHI HUB BROADWAY HAYMARKET NS AUS Card xx1037 Value Date: 11/07/2024,2789.03,Restaurants,Food
2024-07-16,-10.0,SMP*Hero Sushi George Sydney AU AUS Card xx1037 Value Date: 13/07/2024,2801.33,Restaurants,Food
2024-07-16,-54.99,LinkedIn Pre P10153128 lnkd.in/bill AU AUS Card xx1037 Value Date: 14/07/2024,2811.33,Online Subscriptions,Technology and Services
2024-07-16,-4.49,APPLE.COM/BILL SYDNEY AU AUS Card xx1037 Value Date: 13/07/2024,2866.32,Apple,Technology and Services
2024-07-16,-10.0,TRANSPORTFORNSW OPAL CHIPPENDALE AUS Card xx1037 Value Date: 13/07/2024,2870.81,Transport,Living Expenses
2024-07-15,-16.9,Krispy Kreme Central 2 - 6 Lee StrAU,2880.81,Food and Beverage,Food
2024-07-15,-26.95,QBD THE BOOKSHOP BROADWAY AU,2897.71,Book,Education
2024-07-14,-7.3,STARBUCKS COFFEE B00 SYDNEY AU,2924.66,Coffee,Food
2024-07-14,-25.69,EXQUISITE DINING PL HAYMARKET NSWAU,2931.96,Restaurants,Food
2024-07-14,-7.5,TSG DIXON HAYMARKET NSW AU,2957.65,Grocery,Food
2024-07-13,-8.4,STARBUCKS COFFEE B00 SYDNEY AU,2965.15,Coffee,Food
2024-07-13,-17.2,Transfer To Agnes Lin PayID Phone from CommBank App Payment Farros,2973.55,Events,Activities
2024-07-13,-21.81,PANCAKES ON THE ROCKS HAYMARKET NS AUS Card xx1037 Value Date: 11/07/2024,2990.75,Restaurants,Food
2024-07-13,-121.2,MEDIBANK PHI DEBIT MELBOURNE AUS Card xx1037 Value Date: 11/07/2024,3012.56,Student Fees,Education
2024-07-12,-7.9,STARBUCKS COFFEE B00 SYDNEY AU,3133.76,Coffee,Food
2024-07-12,-35.0,TIMEZONE HAYMARKET AU Card xx1037,3141.66,Entertainment,Activities
2024-07-12,-3.4,PROVENDER HOLDINGS AUS Waterloo AU AUS Card xx1037 Value Date: 10/07/2024,3176.66,Vending Machine,Food
2024-07-12,-0.1,International Transaction Fee Value Date: 09/07/2024,3180.06,Student Fees,Education
2024-07-12,-2.73,Google Storage Mountain View CA USA Card xx1037 IDR 29859.00 Value Date: 09/07/2024,3180.16,Online Subscriptions,Technology and Services
2024-07-12,-18.65,BROAD WAVE PTY LTD BROADWAY NS AUS Card xx1037 Value Date: 10/07/2024,3182.89,Restaurants,Food
2024-07-12,-4.2,Provender Australia SilverwateNSWAU,3201.54,Vending Machine,Food
2024-07-11,-32.8,NANDOS BROADWAY NSW Broadway AU AUS Card xx1037 Value Date: 09/07/2024,3205.74,Restaurants,Food
2024-07-11,-16.3,SUSHI HUB SKYVIEW PL SYDNEY NS AUS Card xx1037 Value Date: 08/07/2024,3238.54,Restaurants,Food
2024-07-11,-3.4,Provender Australia SilverwateNSWAU,3254.84,Vending Machine,Food
2024-07-11,-3.4,Provender Australia SilverwateNSWAU,3258.24,Vending Machine,Food
2024-07-11,-4.2,Provender Australia SilverwateNSWAU,3261.64,Vending Machine,Food
2024-07-10,-15.24,CHICKEN FACTORY PTY LTD SYDNEY NSW AU,3265.84,Restaurants,Food
2024-07-10,-7.9,STARBUCKS COFFEE B03 ULTIMO AU,3281.08,Coffee,Food
2024-07-10,-13.99,Spotify P2D9073703 Sydney AU AUS Card xx1037 Value Date: 08/07/2024,3288.98,Online Subscriptions,Technology and Services
2024-07-10,-10.3,SUSHI HUB BROADWAY HAYMARKET NS AUS Card xx1037 Value Date: 06/07/2024,3302.97,Restaurants,Food
2024-07-10,-3.4,Provender Australia SilverwateNSWAU,3313.27,Vending Machine,Food
2024-07-10,-4.2,Provender Australia SilverwateNSWAU,3316.67,Vending Machine,Food
2024-07-09,-17.99,Canva* 04207-22342765,3320.87,Online Subscriptions,Technology and Services
2024-07-09,3185.0,IZMIRTA RACHMAN REF 2024070900009670,3338.86,Credit,Financial Transactions
2024-07-09,-23.34,PANCAKES ON THE ROCKS HAYMARKET NS AUS Card xx1037 Value Date: 05/07/2024,153.86,Restaurants,Food
2024-07-09,-14.11,HUNGER KEBAB PTY LTD ULTIMO NS AUS Card xx1037 Value Date: 04/07/2024,177.2,Restaurants,Food
2024-07-09,-32.8,NANDOS BROADWAY NSW Broadway AU AUS Card xx1037 Value Date: 06/07/2024,191.31,Restaurants,Food
2024-07-09,-33.48,APPLE.COM/BILL SYDNEY AU AUS Card xx1037 Value Date: 05/07/2024,224.11,Apple,Technology and Services
2024-07-09,-69.0,JB HI FI BROADWAY BROADWAY NS AUS Card xx1037 Value Date: 06/07/2024,257.59,Shopping,Financial Transactions
2024-07-09,-4.2,Provender Australia SilverwateNSWAU,326.59,Vending Machine,Food
2024-07-09,-4.2,Provender Australia SilverwateNSWAU,330.79,Vending Machine,Food
2024-07-08,-21.83,SQ *ENJOY MIE Ultimo AU,334.99,Restaurants,Food
2024-07-07,-21.74,FAT FISH Annandale AU,356.82,Restaurants,Food
2024-07-07,-3.4,Provender Australia SilverwateNSWAU,378.56,Vending Machine,Food
2024-07-07,-3.4,Provender Australia SilverwateNSWAU,381.96,Vending Machine,Food
2024-07-07,-4.2,Provender Australia SilverwateNSWAU,385.36,Vending Machine,Food
2024-07-06,-7.9,STARBUCKS COFFEE B01 CHIPPENDALE AU,389.56,Coffee,Food
2024-07-06,-15.2,WOOLWORTHS 1905 SYDNEY AU AUS Card xx1037 Value Date: 04/07/2024,397.46,Grocery,Food
2024-07-06,-4.0,IGLU LAUNDRY - BROADWA AUSTRALIA AU AUS Card xx1037 Value Date: 03/07/2024,412.66,Rent,Living Expenses
2024-07-06,-4.0,IGLU LAUNDRY - BROADWA AUSTRALIA AU AUS Card xx1037 Value Date: 03/07/2024,416.66,Rent,Living Expenses
2024-07-06,-4.0,IGLU LAUNDRY - BROADWA AUSTRALIA AU AUS Card xx1037 Value Date: 04/07/2024,420.66,Rent,Living Expenses
2024-07-06,-4.0,IGLU LAUNDRY - BROADWA AUSTRALIA AU AUS Card xx1037 Value Date: 04/07/2024,424.66,Rent,Living Expenses
2024-07-06,-9.99,APPLE.COM/BILL SYDNEY AU AUS Card xx1037 Value Date: 03/07/2024,428.66,Apple,Technology and Services
2024-07-05,-123.68,Direct Debit 119218 Vodafone Aus A3-2afb0401d,438.65,Mobile Services,Technology and Services
2024-07-05,-26.29,SWEET TOWN ON GEORGE S HAYMARKET 02 AUS Card xx1037 Value Date: 03/07/2024,562.33,Restaurants,Food
2024-07-04,-1104.85,Direct Debit 505091 IGLU NO205 PTY 66935,588.62,Rent,Living Expenses
2024-07-04,-5.08,Kensington Investment Chippendale AU,1693.47,Rent,Living Expenses
2024-07-04,-15.15,Kensington Investment Chippendale AU,1698.55,Rent,Living Expenses
2024-07-04,-13.99,CRUNCHYROLL *AUD 415-503-9235 CA USA Card xx1037 AUD 13.99 Value Date: 01/07/2024,1713.7,Online Subscriptions,Technology and Services
2024-07-04,-23.24,SWEET TOWN ON GEORGE S HAYMARKET 02 AUS Card xx1037 Value Date: 02/07/2024,1727.69,Restaurants,Food
2024-07-03,-7.9,STARBUCKS COFFEE B00 SYDNEY AU,1750.93,Coffee,Food
2024-07-03,-28.39,Roll'd Westfield Sydney AU,1758.83,Restaurants,Food
2024-07-03,-32.8,NANDOS BROADWAY NSW Broadway AU AUS Card xx1037 Value Date: 01/07/2024,1787.22,Restaurants,Food
2024-07-03,-29.99,ADOBE ADOBE.LY/ENAU AU AUS Card xx1037 Value Date: 01/07/2024,1820.02,Online Subscriptions,Technology and Services
2024-07-02,-7.9,STARBUCKS COFFEE B00 SYDNEY AU,1850.01,Coffee,Food
2024-07-02,-35.0,TIMEZONE HAYMARKET AU Card xx1037,1857.91,Entertainment,Activities
2024-07-02,-21.83,SQ *ENJOY MIE Ultimo AU,1892.91,Restaurants,Food
2024-07-02,-31.8,NANDOS BROADWAY NSW Broadway AU AUS Card xx1037 Value Date: 28/06/2024,1914.74,Restaurants,Food
2024-07-02,-24.81,PANCAKES ON THE ROCKS HAYMARKET NS AUS Card xx1037 Value Date: 30/06/2024,1946.54,Restaurants,Food
2024-07-01,-3.4,Provender Australia SilverwateNSWAU,1971.35,Vending Machine,Food
2024-07-01,-3.0,Provender Australia SilverwateNSWAU,1974.75,Vending Machine,Food
2024-07-01,-3.0,Provender Australia SilverwateNSWAU,1977.75,Vending Machine,Food
2024-07-01,-6.5,STARBUCKS COFFEE B01 CHIPPENDALE AU,1980.75,Coffee,Food
